㑩	T	儸
㓥	T	劏
㔉	T	劚
㖊	T	噚
㖞	T	喎
㛟	T	
㛠	T	
㛿	T	
㟆	T	㠏
㠏	S	㟆
㧑	T	撝
㧟	T	擓
㨫	T	㩜
㩜	S	㨫
㱩	T	殰
㱮	T	殨
㲿	T	瀇
㶉	T	鸂
㶶	T	燶
㶽	T	煱
㺍	T	獱
㻏	T	
㻘	T	
䁖	T	瞜
䅉	T	稏
䇲	T	筴
䊷	S	䌶
䋙	S	䌺
䋻	S	䌾
䌶	T	䊷
䌷	T	紬
䌸	T	縳
䌹	T	絅
䌺	T	䋙
䌼	T	綐
䌽	T	綵
䌾	T	䋻
䍀	T	繿
䍁	T	繸
䓕	T	薳
䗖	T	螮
䘛	T	
䙊	T	
䙓	T	襬
䜣	T	訢
䜥	T	
䜧	T	譅
䝙	T	貙
䝼	S	䞍
䞌	T	
䞍	T	䝼
䞐	T	賰
䢂	T	
䥿	T	
䦀	T	
䦁	T	
䩄	T	靦
䯀	S	䯅
䯃	T	
䯄	T	騧
䯅	T	䯀
䰾	S	鲃
䱽	S	䲝
䲁	S	鳚
䲝	T	䱽
䲞	T	
䴓	T	鳾
䴔	T	鵁
䴕	T	鴷
䴖	T	鶄
䴗	T	鶪
䴘	T	鷈
䴙	T	鷿
万	T	萬
与	T	與
丑	T	醜
专	T	專
业	T	業
丛	T	叢
东	T	東
丝	T	絲
丟	S	丢
丢	T	丟
两	T	兩
严	T	嚴
並	S	并
丧	T	喪
个	T	個
丰	T	豐
临	T	臨
为	T	為 爲
丽	T	麗
举	T	舉
么	T	幺 麼 麽
义	T	義
乌	T	烏
乐	T	樂
乔	T	喬
习	T	習
乡	T	鄉
书	T	書
买	T	買
乱	T	亂
乾	S	干
亂	S	乱
争	T	爭
于	T	於
亏	T	虧
云	T	雲
亚	T	亞
亞	S	亚
产	T	產 産
亩	T	畝
亲	T	親
亵	T	褻
亸	T	嚲
亿	T	億
仅	T	僅
仆	T	僕
从	T	從
仑	T	侖
仓	T	倉
仪	T	儀
们	T	們
价	T	價
众	T	眾 衆
优	T	優
会	T	會
伛	T	傴
伞	T	傘
伟	T	偉
传	T	傳
伣	T	俔
伤	T	傷
伥	T	倀
伦	T	倫
伧	T	傖
伪	T	偽 僞
伫	T	佇
佇	S	伫
体	T	體
余	S	馀
余	T	餘
佣	T	傭
佥	T	僉
併	S	并
來	S	来
侖	S	仑
侠	T	俠
侣	T	侶
侥	T	僥
侦	T	偵
侧	T	側
侨	T	僑
侩	T	儈
侪	T	儕
侬	T	儂
侶	S	侣
俁	S	俣
係	S	系
俔	S	伣
俠	S	侠
俣	T	俁
俦	T	儔
俨	T	儼
俩	T	倆
俪	T	儷
俫	T	倈
俭	T	儉
倀	S	伥
倆	S	俩
倈	S	俫
倉	S	仓
個	S	个
們	S	们
倫	S	伦
债	T	債
倾	T	傾
偉	S	伟
偬	T	傯
側	S	侧
偵	S	侦
偻	T	僂
偽	S	伪
偾	T	僨
偿	T	償
傑	S	杰
傖	S	伧
傘	S	伞
備	S	备
傥	T	儻
傧	T	儐
储	T	儲
傩	T	儺
傭	S	佣
傯	S	偬
傳	S	传
傴	S	伛
債	S	债
傷	S	伤
傾	S	倾
僂	S	偻
僅	S	仅
僉	S	佥
僑	S	侨
僕	S	仆
僞	S	伪
僥	S	侥
僨	S	偾
價	S	价
儀	S	仪
儂	S	侬
億	S	亿
儈	S	侩
儉	S	俭
儐	S	傧
儔	S	俦
儕	S	侪
儘	S	尽
償	S	偿
優	S	优
儲	S	储
儷	S	俪
儸	S	㑩
儺	S	傩
儻	S	傥
儼	S	俨
儿	T	兒
克	T	剋
兌	S	兑
兑	T	兌
兒	S	儿
兖	T	兗
兗	S	兖
党	T	黨
內	S	内
兩	S	两
兰	T	蘭
关	T	關
兴	T	興
兹	T	茲
养	T	養
兽	T	獸
冁	T	囅
内	T	內
冈	T	岡
冊	S	册
册	T	冊
写	T	寫
军	T	軍
农	T	農
冪	S	幂
冯	T	馮
冲	T	沖 衝
决	T	決
况	T	況
冻	T	凍
净	T	凈
准	T	準
凈	S	净
凉	T	涼
凍	S	冻
减	T	減
凑	T	湊
凛	T	凜
凜	S	凛
几	T	幾
凤	T	鳳
凫	T	鳧 鳬
凭	T	憑
凯	T	凱
凱	S	凯
击	T	擊
凿	T	鑿
刍	T	芻
划	T	劃 畫
刘	T	劉
则	T	則
刚	T	剛
创	T	創
删	T	刪
別	S	别
刪	S	删
别	T	別
刬	T	剗
刭	T	剄
刮	T	颳
制	T	製
刹	T	剎
刽	T	劊
刿	T	劌
剀	T	剴
剂	T	劑
剄	S	刭
則	S	则
剋	S	克
剎	S	刹
剐	T	剮
剑	T	劍
剗	S	刬
剛	S	刚
剝	S	剥
剥	T	剝
剧	T	劇
剮	S	剐
剴	S	剀
創	S	创
劃	S	划
劇	S	剧
劉	S	刘
劊	S	刽
劌	S	刿
劍	S	剑
劏	S	㓥
劑	S	剂
劚	S	㔉
劝	T	勸
办	T	辦
务	T	務
劢	T	勱
动	T	動
励	T	勵
劲	T	勁
劳	T	勞
势	T	勢
勁	S	劲
勋	T	勛
動	S	动
務	S	务
勚	T	勩
勛	S	勋
勝	S	胜
勞	S	劳
勢	S	势
勩	S	勚
勱	S	劢
勵	S	励
勸	S	劝
勻	S	匀
匀	T	勻
匦	T	匭
匭	S	匦
匮	T	匱
匯	S	汇
匱	S	匮
区	T	區
医	T	醫
區	S	区
华	T	華
协	T	協
協	S	协
单	T	單
卖	T	賣
卜	T	蔔
卢	T	盧
卤	T	滷 鹵
卫	T	衛
却	T	卻
卻	S	却
厂	T	廠
厅	T	廳
历	T	曆 歷
厉	T	厲
压	T	壓
厌	T	厭
厍	T	厙
厐	T	龎
厕	T	厠 廁
厘	T	釐
厙	S	厍
厠	S	厕
厢	T	廂
厣	T	厴
厦	T	廈
厨	T	廚
厩	T	廄
厭	S	厌
厮	T	廝
厲	S	厉
厴	S	厣
县	T	縣
叁	T	叄
参	T	參
參	S	参
叄	S	叁
双	T	雙
发	T	發 髮
变	T	變
叙	T	敘
叠	T	疊
叢	S	丛
只	T	衹 隻
台	S	台
台	T	台 檯 臺 颱
叶	T	葉
号	T	號
叹	T	嘆
叽	T	嘰
同	T	衕
后	S	后
后	T	后 後
向	T	曏
吒	S	咤
吓	T	嚇
吕	T	呂
吗	T	嗎
吣	T	唚
吨	T	噸
听	T	聽
启	T	啓 啟
吳	S	吴
吴	T	吳
吶	S	呐
呂	S	吕
呆	S	獃
呐	T	吶
呒	T	嘸
呓	T	囈
呕	T	嘔
呖	T	嚦
呗	T	唄
员	T	員
呙	T	咼
呛	T	嗆
呜	T	嗚
咏	T	詠
咙	T	嚨
咛	T	嚀
咝	T	噝
咤	T	吒
咸	T	鹹
咼	S	呙
响	T	響
哑	T	啞
哒	T	噠
哓	T	嘵
哔	T	嗶
哕	T	噦
哗	T	嘩
哙	T	噲
哜	T	嚌
哝	T	噥
哟	T	喲
員	S	员
唄	S	呗
唚	S	吣
唛	T	嘜
唝	T	嗊
唠	T	嘮
唡	T	啢
唢	T	嗩
唤	T	喚
問	S	问
啓	S	启
啞	S	哑
啟	S	启
啢	S	唡
啧	T	嘖
啬	T	嗇
啭	T	囀
啮	T	嚙
啴	T	嘽
啸	T	嘯
喎	S	㖞
喚	S	唤
喪	S	丧
喬	S	乔
單	S	单
喲	S	哟
喷	T	噴
喽	T	嘍
喾	T	嚳
嗆	S	呛
嗇	S	啬
嗊	S	唝
嗎	S	吗
嗚	S	呜
嗩	S	唢
嗫	T	囁
嗳	T	噯
嗶	S	哔
嘆	S	叹
嘍	S	喽
嘔	S	呕
嘖	S	啧
嘗	S	尝
嘘	T	噓
嘜	S	唛
嘤	T	嚶
嘩	S	哗
嘮	S	唠
嘯	S	啸
嘰	S	叽
嘱	T	囑
嘵	S	哓
嘸	S	呒
嘽	S	啴
噓	S	嘘
噚	S	㖊
噜	T	嚕
噝	S	咝
噠	S	哒
噥	S	哝
噦	S	哕
噯	S	嗳
噲	S	哙
噴	S	喷
噸	S	吨
噹	S	当
嚀	S	咛
嚇	S	吓
嚌	S	哜
嚕	S	噜
嚙	S	啮
嚣	T	囂
嚦	S	呖
嚨	S	咙
嚲	S	亸
嚳	S	喾
嚴	S	严
嚶	S	嘤
囀	S	啭
囁	S	嗫
囂	S	嚣
囅	S	冁
囈	S	呓
囑	S	嘱
团	T	團
囪	S	囱
园	T	園
困	T	睏
囱	T	囪
围	T	圍
囵	T	圇
国	T	國
图	T	圖
圆	T	圓
圇	S	囵
國	S	国
圍	S	围
園	S	园
圓	S	圆
圖	S	图
團	S	团
圣	T	聖
圹	T	壙
场	T	場
坂	T	阪
坏	T	壞
块	T	塊
坚	T	堅
坛	T	壇 罈
坜	T	壢
坝	T	壩
坞	T	塢
坟	T	墳
坠	T	墜
垄	T	壟
垅	T	壠
垆	T	壚
垒	T	壘
垦	T	墾
垩	T	堊
垫	T	墊
垭	T	埡
垱	T	壋
垲	T	塏
垴	T	堖
垵	S	埯
埘	T	塒
埙	T	塤
埚	T	堝
埡	S	垭
埯	T	垵
埰	S	采
執	S	执
堅	S	坚
堊	S	垩
堑	T	塹
堕	T	墮
堖	S	垴
堝	S	埚
堯	S	尧
報	S	报
場	S	场
塊	S	块
塋	S	茔
塏	S	垲
塒	S	埘
塗	S	涂
塢	S	坞
塤	S	埙
塵	S	尘
塹	S	堑
墊	S	垫
墙	T	墻 牆
墜	S	坠
墮	S	堕
墳	S	坟
墻	S	墙
墾	S	垦
壇	S	坛
壈	S	
壋	S	垱
壓	S	压
壘	S	垒
壙	S	圹
壚	S	垆
壞	S	坏
壟	S	垄
壠	S	垅
壢	S	坜
壩	S	坝
壮	T	壯
壯	S	壮
声	T	聲
壳	T	殻 殼
壶	T	壺
壸	T	壼
壺	S	壶
壼	S	壸
壽	S	寿
处	T	處
备	T	備
复	T	復 複 覆
够	T	夠
夠	S	够
夢	S	梦
头	T	頭
夸	T	誇
夹	T	夾
夺	T	奪
夾	S	夹
奁	T	奩
奂	T	奐
奋	T	奮
奐	S	奂
奖	T	奬 獎
奥	T	奧
奧	S	奥
奩	S	奁
奪	S	夺
奬	S	奖
奮	S	奋
奸	T	姦
奼	S	姹
妆	T	妝
妇	T	婦
妈	T	媽
妝	S	妆
妩	T	嫵
妪	T	嫗
妫	T	媯 嬀
姍	S	姗
姗	T	姍
姦	S	奸
姹	T	奼
娄	T	婁
娅	T	婭
娆	T	嬈
娇	T	嬌
娈	T	孌
娛	S	娱
娱	T	娛
娲	T	媧
娴	T	嫻
婁	S	娄
婦	S	妇
婭	S	娅
婳	T	嫿
婴	T	嬰
婵	T	嬋
婶	T	嬸
媧	S	娲
媪	T	媼
媯	S	妫
媼	S	媪
媽	S	妈
嫒	T	嬡
嫔	T	嬪
嫗	S	妪
嫱	T	嬙
嫵	S	妩
嫻	S	娴
嫿	S	婳
嬀	S	妫
嬈	S	娆
嬋	S	婵
嬌	S	娇
嬙	S	嫱
嬡	S	嫒
嬤	S	嬷
嬪	S	嫔
嬰	S	婴
嬷	T	嬤
嬸	S	婶
孌	S	娈
孙	T	孫
学	T	學
孪	T	孿
孫	S	孙
學	S	学
孿	S	孪
宁	T	寧
宝	T	寶
实	T	實
宠	T	寵
审	T	審
宪	T	憲
宫	T	宮
宮	S	宫
宽	T	寬
宾	T	賓
寝	T	寢
寢	S	寝
實	S	实
寧	S	宁
審	S	审
寫	S	写
寬	S	宽
寵	S	宠
寶	S	宝
对	T	對
寻	T	尋
导	T	導
寿	T	壽
将	T	將
將	S	将
專	S	专
尋	S	寻
對	S	对
導	S	导
尔	T	爾
尘	T	塵
尝	T	嘗
尧	T	堯
尴	T	尷
尷	S	尴
尸	T	屍
尽	T	儘 盡
层	T	層
屃	T	屓
屆	S	届
屉	T	屜
届	T	屆
屍	S	尸
屓	S	屃
屜	S	屉
属	T	屬
屡	T	屢
屢	S	屡
層	S	层
屦	T	屨
屨	S	屦
屬	S	属
屿	T	嶼
岁	T	歲
岂	T	豈
岖	T	嶇
岗	T	崗
岘	T	峴
岙	T	嶴
岚	T	嵐
岛	T	島
岡	S	冈
岭	T	嶺
岽	T	崬
岿	T	巋
峄	T	嶧
峡	T	峽
峣	T	嶢
峤	T	嶠
峥	T	崢
峦	T	巒
峴	S	岘
島	S	岛
峽	S	峡
崂	T	嶗
崃	T	崍
崄	T	嶮
崍	S	崃
崗	S	岗
崢	S	峥
崬	S	岽
崭	T	嶄
嵐	S	岚
嵘	T	嶸
嵚	T	嶔
嵝	T	嶁
嶁	S	嵝
嶄	S	崭
嶇	S	岖
嶔	S	嵚
嶗	S	崂
嶠	S	峤
嶢	S	峣
嶧	S	峄
嶮	S	崄
嶴	S	岙
嶸	S	嵘
嶺	S	岭
嶼	S	屿
巅	T	巔
巋	S	岿
巒	S	峦
巔	S	巅
巩	T	鞏
巯	T	巰
巰	S	巯
币	T	幣
帅	T	帥
师	T	師
帏	T	幃
帐	T	帳
帘	T	簾
帜	T	幟
帥	S	帅
带	T	帶
帧	T	幀
師	S	师
帮	T	幫
帱	T	幬
帳	S	帐
帶	S	带
帻	T	幘
帼	T	幗
幀	S	帧
幂	T	冪
幃	S	帏
幗	S	帼
幘	S	帻
幟	S	帜
幣	S	币
幫	S	帮
幬	S	帱
干	T	乾 幹
并	T	並 併
幹	S	干
幺	S	么
幾	S	几
广	T	廣
庄	T	莊
庆	T	慶
庐	T	廬
庑	T	廡
库	T	庫
应	T	應
庙	T	廟
庞	T	龐
废	T	廢
庫	S	库
廁	S	厕
廂	S	厢
廄	S	厩
廈	S	厦
廚	S	厨
廝	S	厮
廟	S	庙
廠	S	厂
廡	S	庑
廢	S	废
廣	S	广
廩	S	廪
廪	T	廩
廬	S	庐
廳	S	厅
开	T	開
异	T	異
弃	T	棄
弑	T	弒
弒	S	弑
张	T	張
弥	T	彌
弪	T	弳
弯	T	彎
弳	S	弪
張	S	张
強	S	强
弹	T	彈
强	T	強
彈	S	弹
彌	S	弥
彎	S	弯
归	T	歸
当	T	噹 當
录	T	錄 録
彙	S	汇
彝	T	彞
彞	S	彝
彥	S	彦
彦	T	彥
彻	T	徹
征	T	徵
径	T	徑
後	S	后
徑	S	径
徕	T	徠
從	S	从
徠	S	徕
御	T	禦
復	S	复
徵	S	征
徹	S	彻
忆	T	憶
忏	T	懺
志	S	志
志	T	志 誌
忧	T	憂
忾	T	愾
怀	T	懷
态	T	態
怂	T	慫
怃	T	憮
怄	T	慪
怅	T	悵
怆	T	愴
怜	T	憐
总	T	總
怼	T	懟
怿	T	懌
恆	S	恒
恋	T	戀
恒	T	恆
恥	S	耻
恳	T	懇
恶	T	惡
恸	T	慟
恹	T	懨
恺	T	愷
恻	T	惻
恼	T	惱
恽	T	惲
悅	S	悦
悞	S	悮
悦	T	悅
悫	T	愨 慤
悬	T	懸
悭	T	慳
悮	T	悞
悯	T	憫
悵	S	怅
悶	S	闷
惊	T	驚
惡	S	恶
惧	T	懼
惨	T	慘
惩	T	懲
惫	T	憊
惬	T	愜
惭	T	慚
惮	T	憚
惯	T	慣
惱	S	恼
惲	S	恽
惻	S	恻
愛	S	爱
愜	S	惬
愠	T	慍
愤	T	憤
愦	T	憒
愨	S	悫
愴	S	怆
愷	S	恺
愾	S	忾
愿	T	願
慄	S	栗
態	S	态
慍	S	愠
慑	T	懾
慘	S	惨
慚	S	惭
慟	S	恸
慣	S	惯
慤	S	悫
慪	S	怄
慫	S	怂
慮	S	虑
慳	S	悭
慶	S	庆
憂	S	忧
憊	S	惫
憐	S	怜
憑	S	凭
憒	S	愦
憚	S	惮
憤	S	愤
憫	S	悯
憮	S	怃
憲	S	宪
憶	S	忆
懇	S	恳
應	S	应
懌	S	怿
懍	S	懔
懑	T	懣
懒	T	懶
懔	T	懍
懟	S	怼
懣	S	懑
懨	S	恹
懲	S	惩
懶	S	懒
懷	S	怀
懸	S	悬
懺	S	忏
懼	S	惧
懾	S	慑
戀	S	恋
戆	T	戇
戇	S	戆
戋	T	戔
戏	T	戲
戔	S	戋
戗	T	戧
战	T	戰
戧	S	戗
戩	S	戬
戬	T	戩
戯	T	戱
戰	S	战
戱	S	戯
戲	S	戏
戶	S	户
户	T	戶
扑	T	撲
执	T	執
扩	T	擴
扪	T	捫
扫	T	掃
扬	T	揚
扰	T	擾
抚	T	撫
抛	T	拋
抟	T	摶
抠	T	摳
抡	T	掄
抢	T	搶
护	T	護
报	T	報
担	T	擔
拋	S	抛
拟	T	擬
拢	T	攏
拣	T	揀
拥	T	擁
拦	T	攔
拧	T	擰
拨	T	撥
择	T	擇
挂	T	掛
挚	T	摯
挛	T	攣
挜	T	掗
挝	T	撾
挞	T	撻
挟	T	挾
挠	T	撓
挡	T	擋
挢	T	撟
挣	T	掙
挤	T	擠
挥	T	揮
挦	T	撏
挩	S	捝
挽	T	輓
挾	S	挟
捝	T	挩
捞	T	撈
损	T	損
捡	T	撿
换	T	換
捣	T	搗
捨	S	舍
捫	S	扪
据	T	據
掃	S	扫
掄	S	抡
掗	S	挜
掙	S	挣
掛	S	挂
採	S	采
掳	T	擄
掴	T	摑
掷	T	擲
掸	T	撣
掺	T	摻
掼	T	摜
揀	S	拣
揚	S	扬
換	S	换
揮	S	挥
揽	T	攬
揾	T	搵
揿	T	撳
搀	T	攙
搁	T	擱
搂	T	摟
搅	T	攪
損	S	损
搖	S	摇
搗	S	捣
搵	S	揾
搶	S	抢
携	T	攜
摄	T	攝
摅	T	攄
摆	T	擺
摇	T	搖
摈	T	擯
摊	T	攤
摑	S	掴
摜	S	掼
摟	S	搂
摯	S	挚
摳	S	抠
摶	S	抟
摻	S	掺
撄	T	攖
撈	S	捞
撏	S	挦
撐	S	撑
撑	T	撐
撓	S	挠
撝	S	㧑
撟	S	挢
撣	S	掸
撥	S	拨
撫	S	抚
撲	S	扑
撳	S	揿
撵	T	攆
撷	T	擷
撸	T	擼
撺	T	攛
撻	S	挞
撾	S	挝
撿	S	捡
擁	S	拥
擄	S	掳
擇	S	择
擊	S	击
擋	S	挡
擓	S	㧟
擔	S	担
據	S	据
擞	T	擻
擠	S	挤
擬	S	拟
擯	S	摈
擰	S	拧
擱	S	搁
擲	S	掷
擴	S	扩
擷	S	撷
擺	S	摆
擻	S	擞
擼	S	撸
擾	S	扰
攄	S	摅
攆	S	撵
攏	S	拢
攒	T	攢
攔	S	拦
攖	S	撄
攙	S	搀
攛	S	撺
攜	S	携
攝	S	摄
攢	S	攒
攣	S	挛
攤	S	摊
攪	S	搅
攬	S	揽
敌	T	敵
敗	S	败
敘	S	叙
敛	T	斂
数	T	數
敵	S	敌
數	S	数
斂	S	敛
斃	S	毙
斋	T	齋
斓	T	斕
斕	S	斓
斗	T	鬥
斩	T	斬
斬	S	斩
断	T	斷
斷	S	断
於	S	于
无	T	無
旧	T	舊
时	T	時
旷	T	曠
旸	T	暘
昙	T	曇
昼	T	晝
昽	T	曨
显	T	顯
時	S	时
晉	S	晋
晋	T	晉
晒	T	曬
晓	T	曉
晔	T	曄
晕	T	暈
晖	T	暉
晝	S	昼
暂	T	暫
暈	S	晕
暉	S	晖
暘	S	旸
暢	S	畅
暧	T	曖
暫	S	暂
曄	S	晔
曆	S	历
曇	S	昙
曉	S	晓
曏	S	向
曖	S	暧
曠	S	旷
曨	S	昽
曬	S	晒
書	S	书
會	S	会
朧	S	胧
术	T	術
朴	T	樸
机	T	機
杀	T	殺
杂	T	雜
权	T	權
杆	T	桿
条	T	條
来	T	來
杨	T	楊
杩	T	榪
杰	T	傑
東	S	东
杴	S	锨
松	T	鬆
板	T	闆
极	S	极
极	T	极 極
构	T	構
枞	T	樅
枢	T	樞
枣	T	棗
枥	T	櫪
枧	T	梘
枨	T	棖
枪	T	槍
枫	T	楓
枭	T	梟
柜	T	櫃
柠	T	檸
柵	S	栅
柽	T	檉
栀	T	梔
栅	T	柵
标	T	標
栈	T	棧
栉	T	櫛
栊	T	櫳
栋	T	棟
栌	T	櫨
栎	T	櫟
栏	T	欄
树	T	樹
栖	T	棲
栗	T	慄
样	T	樣
栾	T	欒
桠	T	椏
桡	T	橈
桢	T	楨
档	T	檔
桤	T	榿
桥	T	橋
桦	T	樺
桧	T	檜
桨	T	槳
桩	T	樁
桿	S	杆
梔	S	栀
梘	S	枧
條	S	条
梟	S	枭
梦	T	夢
梲	S	棁
梼	T	檮
梾	T	棶
梿	T	槤
检	T	檢
棁	T	梲
棂	T	欞
棄	S	弃
棖	S	枨
棗	S	枣
棟	S	栋
棧	S	栈
棲	S	栖
棶	S	梾
椁	T	槨
椏	S	桠
椟	T	櫝
椠	T	槧
椤	T	欏
椭	T	橢
楊	S	杨
楓	S	枫
楨	S	桢
業	S	业
極	S	极
楼	T	樓
榄	T	欖
榅	T	榲
榇	T	櫬
榈	T	櫚
榉	T	櫸
榪	S	杩
榮	S	荣
榲	S	榅
榿	S	桤
構	S	构
槍	S	枪
槚	T	檟
槛	T	檻
槟	T	檳
槠	T	櫧
槤	S	梿
槧	S	椠
槨	S	椁
槳	S	桨
樁	S	桩
樂	S	乐
樅	S	枞
樓	S	楼
標	S	标
樞	S	枢
樣	S	样
横	T	橫
樯	T	檣
樱	T	櫻
樸	S	朴
樹	S	树
樺	S	桦
橈	S	桡
橋	S	桥
機	S	机
橢	S	椭
橥	T	櫫
橫	S	横
橱	T	櫥
橹	T	櫓
橼	T	櫞
檁	S	檩
檉	S	柽
檔	S	档
檜	S	桧
檟	S	槚
檢	S	检
檣	S	樯
檩	T	檁
檮	S	梼
檯	S	台
檳	S	槟
檸	S	柠
檻	S	槛
櫃	S	柜
櫓	S	橹
櫚	S	榈
櫛	S	栉
櫝	S	椟
櫞	S	橼
櫟	S	栎
櫥	S	橱
櫧	S	槠
櫨	S	栌
櫪	S	枥
櫫	S	橥
櫬	S	榇
櫱	S	蘖
櫳	S	栊
櫸	S	榉
櫻	S	樱
欄	S	栏
權	S	权
欏	S	椤
欒	S	栾
欖	S	榄
欞	S	棂
欢	T	歡
欤	T	歟
欧	T	歐
欽	S	钦
歐	S	欧
歟	S	欤
歡	S	欢
歲	S	岁
歷	S	历
歸	S	归
歼	T	殲
歿	S	殁
殁	T	歿
殇	T	殤
残	T	殘
殒	T	殞
殓	T	殮
殘	S	残
殚	T	殫
殞	S	殒
殡	T	殯
殤	S	殇
殨	S	㱮
殫	S	殚
殮	S	殓
殯	S	殡
殰	S	㱩
殲	S	歼
殴	T	毆
殺	S	杀
殻	S	壳
殼	S	壳
毀	S	毁
毁	T	毀
毂	T	轂
毆	S	殴
毕	T	畢
毙	T	斃
毡	T	氈
毵	T	毿
毿	S	毵
氂	S	牦
氇	T	氌
氈	S	毡
氌	S	氇
气	T	氣
氢	T	氫
氣	S	气
氩	T	氬
氫	S	氢
氬	S	氩
氲	T	氳
氳	S	氲
汇	T	匯 彙
汉	T	漢
汤	T	湯
汹	T	洶
決	S	决
沈	T	瀋
沒	S	没
沖	S	冲
沟	T	溝
没	T	沒
沣	T	灃
沤	T	漚
沥	T	瀝
沦	T	淪
沧	T	滄
沩	T	溈 潙
沪	T	滬
況	S	况
泞	T	濘
注	T	註
泪	T	淚
泶	T	澩
泷	T	瀧
泸	T	瀘
泺	T	濼
泻	T	瀉
泼	T	潑
泽	T	澤
泾	T	涇
洁	T	潔
洒	T	灑
洶	S	汹
洼	T	窪
浃	T	浹
浅	T	淺
浆	T	漿
浇	T	澆
浈	T	湞
浊	T	濁
测	T	測
浍	T	澮
济	T	濟
浏	T	瀏
浐	T	滻
浑	T	渾
浒	T	滸
浓	T	濃
浔	T	潯
浹	S	浃
涂	T	塗
涇	S	泾
涛	T	濤
涝	T	澇
涞	T	淶
涟	T	漣
涠	T	潿
涡	T	渦
涣	T	渙
涤	T	滌
润	T	潤
涧	T	澗
涨	T	漲
涩	T	澀
涼	S	凉
淀	T	澱
淚	S	泪
淥	S	渌
淪	S	沦
淵	S	渊
淶	S	涞
淺	S	浅
渊	T	淵
渌	T	淥
渍	T	漬
渎	T	瀆
渐	T	漸
渑	T	澠
渔	T	漁
渖	T	瀋
渗	T	滲
渙	S	涣
減	S	减
渦	S	涡
温	T	溫
測	S	测
渾	S	浑
湊	S	凑
湞	S	浈
湯	S	汤
湾	T	灣
湿	T	濕
溃	T	潰
溅	T	濺
溆	T	漵
溈	S	沩
準	S	准
溝	S	沟
溫	S	温
滄	S	沧
滅	S	灭
滌	S	涤
滎	S	荥
滗	T	潷
滚	T	滾
滞	T	滯
滟	T	灧
滠	T	灄
满	T	滿
滢	T	瀅
滤	T	濾
滥	T	濫
滦	T	灤
滨	T	濱
滩	T	灘
滪	T	澦
滬	S	沪
滯	S	滞
滲	S	渗
滷	S	卤
滸	S	浒
滻	S	浐
滾	S	滚
滿	S	满
漁	S	渔
漓	T	灕
漚	S	沤
漢	S	汉
漣	S	涟
漤	T	灠
漬	S	渍
漲	S	涨
漵	S	溆
漸	S	渐
漿	S	浆
潁	S	颍
潆	T	瀠
潇	T	瀟
潋	T	瀲
潍	T	濰
潑	S	泼
潔	S	洁
潙	S	沩
潛	S	潜
潜	T	潛
潤	S	润
潯	S	浔
潰	S	溃
潴	T	瀦
潷	S	滗
潿	S	涠
澀	S	涩
澆	S	浇
澇	S	涝
澗	S	涧
澜	T	瀾
澠	S	渑
澤	S	泽
澦	S	滪
澩	S	泶
澮	S	浍
澱	S	淀
濁	S	浊
濃	S	浓
濑	T	瀨
濒	T	瀕
濕	S	湿
濘	S	泞
濟	S	济
濤	S	涛
濫	S	滥
濰	S	潍
濱	S	滨
濺	S	溅
濼	S	泺
濾	S	滤
瀅	S	滢
瀆	S	渎
瀇	S	㲿
瀉	S	泻
瀋	S	沈 渖
瀏	S	浏
瀕	S	濒
瀘	S	泸
瀝	S	沥
瀟	S	潇
瀠	S	潆
瀦	S	潴
瀧	S	泷
瀨	S	濑
瀲	S	潋
瀾	S	澜
灃	S	沣
灄	S	滠
灏	T	灝
灑	S	洒
灕	S	漓
灘	S	滩
灝	S	灏
灠	S	漤
灣	S	湾
灤	S	滦
灧	S	滟
灭	T	滅
灯	T	燈
灵	T	靈
灶	T	竈
災	S	灾
灾	T	災
灿	T	燦
炀	T	煬
炉	T	爐
炖	T	燉
炜	T	煒
炝	T	熗
点	T	點
為	S	为
炼	T	煉
炽	T	熾
烁	T	爍
烂	T	爛
烃	T	烴
烏	S	乌
烛	T	燭
烟	T	煙
烦	T	煩
烧	T	燒
烨	T	燁
烩	T	燴
烫	T	燙
烬	T	燼
热	T	熱
烴	S	烃
焕	T	煥
焖	T	燜
焘	T	燾
無	S	无
煉	S	炼
煒	S	炜
煙	S	烟
煢	S	茕
煥	S	焕
煩	S	烦
煬	S	炀
煱	S	㶽
煴	T	熅
熅	S	煴
熒	S	荧
熗	S	炝
熱	S	热
熲	S	颎
熾	S	炽
燁	S	烨
燈	S	灯
燉	S	炖
燒	S	烧
燙	S	烫
燜	S	焖
營	S	营
燦	S	灿
燭	S	烛
燴	S	烩
燶	S	㶶
燼	S	烬
燾	S	焘
爍	S	烁
爐	S	炉
爛	S	烂
爭	S	争
爱	T	愛
爲	S	为
爷	T	爺
爺	S	爷
爾	S	尔
牆	S	墙
牍	T	牘
牘	S	牍
牦	T	氂
牵	T	牽
牺	T	犧
牽	S	牵
犊	T	犢
犖	S	荦
犢	S	犊
犧	S	牺
状	T	狀
犷	T	獷
犸	T	獁
犹	T	猶
狀	S	状
狈	T	狽
狝	T	獮
狞	T	獰
独	T	獨
狭	T	狹
狮	T	獅
狯	T	獪
狰	T	猙
狱	T	獄
狲	T	猻
狹	S	狭
狽	S	狈
猃	T	獫
猎	T	獵
猕	T	獼
猙	S	狰
猡	T	玀
猪	T	豬
猫	T	貓
猬	T	蝟
献	T	獻
猶	S	犹
猻	S	狲
獁	S	犸
獃	S	呆
獄	S	狱
獅	S	狮
獎	S	奖
獨	S	独
獪	S	狯
獫	S	猃
獭	T	獺
獮	S	狝
獰	S	狞
獱	S	㺍
獲	S	获
獵	S	猎
獷	S	犷
獸	S	兽
獺	S	獭
獻	S	献
獼	S	猕
玀	S	猡
玑	T	璣
玚	T	瑒
玛	T	瑪
玮	T	瑋
环	T	環
现	T	現
玱	T	瑲
玺	T	璽
珐	T	琺
珑	T	瓏
珰	T	璫
珲	T	琿
現	S	现
琏	T	璉
琐	T	瑣
琺	S	珐
琼	T	瓊
琿	S	珲
瑋	S	玮
瑒	S	玚
瑣	S	琐
瑤	S	瑶
瑩	S	莹
瑪	S	玛
瑲	S	玱
瑶	T	瑤
瑷	T	璦
璉	S	琏
璎	T	瓔
璣	S	玑
璦	S	瑷
璫	S	珰
環	S	环
璽	S	玺
瓊	S	琼
瓏	S	珑
瓒	T	瓚
瓔	S	璎
瓚	S	瓒
瓯	T	甌
甌	S	瓯
產	S	产
産	S	产
电	T	電
画	T	畫
畅	T	暢
畝	S	亩
畢	S	毕
畫	S	划 画
異	S	异
畴	T	疇
當	S	当
疇	S	畴
疊	S	叠
疖	T	癤
疗	T	療
疟	T	瘧
疠	T	癘
疡	T	瘍
疬	T	癧
疭	T	瘲
疮	T	瘡
疯	T	瘋
疱	T	皰
疴	T	痾
症	T	癥
痈	T	癰
痉	T	痙
痒	T	癢
痖	T	瘂
痙	S	痉
痨	T	癆
痪	T	瘓
痫	T	癇
痾	S	疴
瘂	S	痖
瘅	T	癉
瘆	T	瘮
瘋	S	疯
瘍	S	疡
瘓	S	痪
瘗	T	瘞
瘘	T	瘺 瘻
瘞	S	瘗
瘡	S	疮
瘧	S	疟
瘪	T	癟
瘫	T	癱
瘮	S	瘆
瘲	S	疭
瘺	S	瘘
瘻	S	瘘
瘾	T	癮
瘿	T	癭
療	S	疗
癆	S	痨
癇	S	痫
癉	S	瘅
癘	S	疠
癞	T	癩
癟	S	瘪
癢	S	痒
癣	T	癬
癤	S	疖
癥	S	症
癧	S	疬
癩	S	癞
癫	T	癲
癬	S	癣
癭	S	瘿
癮	S	瘾
癰	S	痈
癱	S	瘫
癲	S	癫
發	S	发
皑	T	皚
皚	S	皑
皰	S	疱
皱	T	皺
皲	T	皸
皸	S	皲
皺	S	皱
盏	T	盞
盐	T	鹽
监	T	監
盖	T	蓋
盗	T	盜
盘	T	盤
盜	S	盗
盞	S	盏
盡	S	尽
監	S	监
盤	S	盘
盧	S	卢
盪	S	荡
眍	T	瞘
眥	S	眦
眦	T	眥
眬	T	矓
眾	S	众
着	T	著
睁	T	睜
睏	S	困
睐	T	睞
睑	T	瞼
睜	S	睁
睞	S	睐
瞆	T	瞶
瞒	T	瞞
瞘	S	眍
瞜	S	䁖
瞞	S	瞒
瞩	T	矚
瞶	S	瞆
瞼	S	睑
矓	S	眬
矚	S	瞩
矫	T	矯
矯	S	矫
矶	T	磯
矾	T	礬
矿	T	礦
砀	T	碭
码	T	碼
砖	T	磚
砗	T	硨
砚	T	硯
砜	T	碸
砺	T	礪
砻	T	礱
砾	T	礫
础	T	礎
硁	T	硜
硕	T	碩
硖	T	硤
硗	T	磽
硙	T	磑
硜	S	硁
硤	S	硖
硨	S	砗
确	T	確
硯	S	砚
硷	T	礆 鹼
碍	T	礙
碛	T	磧
碜	T	磣
碩	S	硕
碭	S	砀
碱	T	鹼
碸	S	砜
確	S	确
碼	S	码
磑	S	硙
磚	S	砖
磣	S	碜
磧	S	碛
磯	S	矶
磽	S	硗
礆	S	硷
礎	S	础
礙	S	碍
礦	S	矿
礪	S	砺
礫	S	砾
礬	S	矾
礱	S	砻
礼	T	禮
祃	T	禡
祎	T	禕
祢	T	禰
祯	T	禎
祷	T	禱
祸	T	禍
祿	S	禄
禀	T	稟
禄	T	祿
禅	T	禪
禍	S	祸
禎	S	祯
禕	S	祎
禡	S	祃
禦	S	御
禪	S	禅
禮	S	礼
禰	S	祢
禱	S	祷
离	T	離
禿	S	秃
秃	T	禿
秆	T	稈
秈	S	籼
种	T	種
积	T	積
称	T	稱
秽	T	穢
秾	T	穠
稅	S	税
稆	T	穭
稈	S	秆
税	T	稅
稏	S	䅉
稟	S	禀
稣	T	穌
種	S	种
稱	S	称
稳	T	穩
穀	S	谷
穌	S	稣
積	S	积
穎	S	颖
穑	T	穡
穠	S	秾
穡	S	穑
穢	S	秽
穩	S	稳
穫	S	获
穭	S	稆
穷	T	窮
窃	T	竊
窍	T	竅
窎	T	窵
窑	T	窯
窜	T	竄
窝	T	窩
窥	T	窺
窦	T	竇
窩	S	窝
窪	S	洼
窭	T	窶
窮	S	穷
窯	S	窑
窵	S	窎
窶	S	窭
窺	S	窥
竄	S	窜
竅	S	窍
竇	S	窦
竈	S	灶
竊	S	窃
竖	T	竪 豎
竞	T	競
竪	S	竖
競	S	竞
笃	T	篤
笋	T	筍
笔	T	筆
笕	T	筧
笺	T	箋
笼	T	籠
笾	T	籩
筆	S	笔
筍	S	笋
筑	T	築
筚	T	篳
筛	T	篩
筜	T	簹
筝	T	箏
筧	S	笕
筴	S	䇲
筹	T	籌
筼	T	篔
签	T	簽
简	T	簡
箋	S	笺
箏	S	筝
箓	T	籙
箦	T	簀
箧	T	篋
箨	T	籜
箩	T	籮
箪	T	簞
箫	T	簫
節	S	节
範	S	范
築	S	筑
篋	S	箧
篑	T	簣
篓	T	簍
篔	S	筼
篤	S	笃
篩	S	筛
篮	T	籃
篱	T	籬
篳	S	筚
簀	S	箦
簍	S	篓
簖	T	籪
簞	S	箪
簡	S	简
簣	S	篑
簫	S	箫
簹	S	筜
簽	S	签
簾	S	帘
籁	T	籟
籃	S	篮
籌	S	筹
籙	S	箓
籜	S	箨
籟	S	籁
籠	S	笼
籩	S	笾
籪	S	簖
籬	S	篱
籮	S	箩
籴	T	糴
类	T	類
籼	T	秈
粜	T	糶
粝	T	糲
粤	T	粵
粪	T	糞
粮	T	糧
粵	S	粤
糁	T	糝
糇	T	餱
糝	S	糁
糞	S	粪
糧	S	粮
糲	S	粝
糴	S	籴
糶	S	粜
糹	S	纟
系	T	係 繫
糾	S	纠
紀	S	纪
紂	S	纣
約	S	约
紅	S	红
紆	S	纡
紇	S	纥
紈	S	纨
紉	S	纫
紋	S	纹
納	S	纳
紐	S	纽
紓	S	纾
純	S	纯
紕	S	纰
紖	S	纼
紗	S	纱
紘	S	纮
紙	S	纸
級	S	级
紛	S	纷
紜	S	纭
紝	S	纴
紡	S	纺
紧	T	緊
紬	S	䌷
累	T	纍
細	S	细
紱	S	绂
紲	S	绁
紳	S	绅
紵	S	纻
紹	S	绍
紺	S	绀
紼	S	绋
紿	S	绐
絀	S	绌
終	S	终
組	S	组
絅	S	䌹
絆	S	绊
絎	S	绗
結	S	结
絕	S	绝
絛	S	绦
絝	S	绔
絞	S	绞
絡	S	络
絢	S	绚
給	S	给
絨	S	绒
絰	S	绖
統	S	统
絲	S	丝
絳	S	绛
絶	S	绝
絷	T	縶
絹	S	绢
綁	S	绑
綃	S	绡
綆	S	绠
綈	S	绨
綉	S	绣
綌	S	绤
綏	S	绥
綐	S	䌼
經	S	经
綜	S	综
綞	S	缍
綠	S	绿
綢	S	绸
綣	S	绻
綫	S	线
綬	S	绶
維	S	维
綯	S	绹
綰	S	绾
綱	S	纲
網	S	网
綳	S	绷
綴	S	缀
綵	S	䌽
綸	S	纶
綹	S	绺
綺	S	绮
綻	S	绽
綽	S	绰
綾	S	绫
綿	S	绵
緄	S	绲
緇	S	缁
緊	S	紧
緋	S	绯
緑	S	绿
緒	S	绪
緓	S	绬
緔	S	绱
緗	S	缃
緘	S	缄
緙	S	缂
線	S	线
緝	S	缉
緞	S	缎
締	S	缔
緡	S	缗
緣	S	缘
緦	S	缌
編	S	编
緩	S	缓
緬	S	缅
緯	S	纬
緱	S	缑
緲	S	缈
練	S	练
緶	S	缏
緹	S	缇
緻	S	致
縈	S	萦
縉	S	缙
縊	S	缢
縋	S	缒
縐	S	绉
縑	S	缣
縕	S	缊
縗	S	缞
縛	S	缚
縝	S	缜
縞	S	缟
縟	S	缛
縣	S	县
縧	S	绦
縫	S	缝
縭	S	缡
縮	S	缩
縱	S	纵
縲	S	缧
縳	S	䌸
縵	S	缦
縶	S	絷
縷	S	缕
縹	S	缥
總	S	总
績	S	绩
繃	S	绷
繅	S	缫
繆	S	缪
繒	S	缯
織	S	织
繕	S	缮
繚	S	缭
繞	S	绕
繡	S	绣
繢	S	缋
繩	S	绳
繪	S	绘
繫	S	系
繭	S	茧
繮	S	缰
繯	S	缳
繰	S	缲
繳	S	缴
繸	S	䍁
繹	S	绎
繼	S	继
繽	S	缤
繾	S	缱
繿	S	䍀
纈	S	缬
纊	S	纩
續	S	续
纍	S	累
纏	S	缠
纓	S	缨
纖	S	纤
纘	S	缵
纜	S	缆
纟	T	糹
纠	T	糾
纡	T	紆
红	T	紅
纣	T	紂
纤	T	纖
纥	T	紇
约	T	約
级	T	級
纨	T	紈
纩	T	纊
纪	T	紀
纫	T	紉
纬	T	緯
纭	T	紜
纮	T	紘
纯	T	純
纰	T	紕
纱	T	紗
纲	T	綱
纳	T	納
纴	T	紝
纵	T	縱
纶	T	綸
纷	T	紛
纸	T	紙
纹	T	紋
纺	T	紡
纻	T	紵
纼	T	紖
纽	T	紐
纾	T	紓
线	T	綫 線
绀	T	紺
绁	T	紲
绂	T	紱
练	T	練
组	T	組
绅	T	紳
细	T	細
织	T	織
终	T	終
绉	T	縐
绊	T	絆
绋	T	紼
绌	T	絀
绍	T	紹
绎	T	繹
经	T	經
绐	T	紿
绑	T	綁
绒	T	絨
结	T	結
绔	T	絝
绕	T	繞
绖	T	絰
绗	T	絎
绘	T	繪
给	T	給
绚	T	絢
绛	T	絳
络	T	絡
绝	T	絕 絶
绞	T	絞
统	T	統
绠	T	綆
绡	T	綃
绢	T	絹
绣	T	綉 繡
绤	T	綌
绥	T	綏
绦	T	絛 縧
继	T	繼
绨	T	綈
绩	T	績
绪	T	緒
绫	T	綾
绬	T	緓
续	T	續
绮	T	綺
绯	T	緋
绰	T	綽
绱	T	緔 鞝
绲	T	緄
绳	T	繩
维	T	維
绵	T	綿
绶	T	綬
绷	T	綳 繃
绸	T	綢
绹	T	綯
绺	T	綹
绻	T	綣
综	T	綜
绽	T	綻
绾	T	綰
绿	T	綠 緑
缀	T	綴
缁	T	緇
缂	T	緙
缃	T	緗
缄	T	緘
缅	T	緬
缆	T	纜
缇	T	緹
缈	T	緲
缉	T	緝
缊	T	縕
缋	T	繢
缌	T	緦
缍	T	綞
缎	T	緞
缏	T	緶
缑	T	緱
缒	T	縋
缓	T	緩
缔	T	締
缕	T	縷
编	T	編
缗	T	緡
缘	T	緣
缙	T	縉
缚	T	縛
缛	T	縟
缜	T	縝
缝	T	縫
缞	T	縗
缟	T	縞
缠	T	纏
缡	T	縭
缢	T	縊
缣	T	縑
缤	T	繽
缥	T	縹
缦	T	縵
缧	T	縲
缨	T	纓
缩	T	縮
缪	T	繆
缫	T	繅
缬	T	纈
缭	T	繚
缮	T	繕
缯	T	繒
缰	T	繮 韁
缱	T	繾
缲	T	繰
缳	T	繯
缴	T	繳
缵	T	纘
缽	S	钵
罂	T	罌
罈	S	坛
罌	S	罂
网	T	網
罗	T	羅
罚	T	罰
罢	T	罷
罰	S	罚
罴	T	羆
罵	S	骂
罷	S	罢
羁	T	羈
羅	S	罗
羆	S	罴
羈	S	羁
羋	S	芈
羟	T	羥
羥	S	羟
義	S	义
習	S	习
翘	T	翹
翹	S	翘
耢	T	耮
耧	T	耬
耬	S	耧
耮	S	耢
耸	T	聳
耻	T	恥
聂	T	聶
聋	T	聾
职	T	職
聍	T	聹
联	T	聯
聖	S	圣
聞	S	闻
聩	T	聵
聪	T	聰
聯	S	联
聰	S	聪
聲	S	声
聳	S	耸
聵	S	聩
聶	S	聂
職	S	职
聹	S	聍
聽	S	听
聾	S	聋
肃	T	肅
肅	S	肃
肠	T	腸
肤	T	膚
肮	T	骯
肴	T	餚
肾	T	腎
肿	T	腫
胀	T	脹
胁	T	脅
胆	T	膽
胜	T	勝
胡	T	衚 鬍
胧	T	朧
胨	T	腖
胪	T	臚
胫	T	脛
胶	T	膠
脅	S	胁
脈	S	脉
脉	T	脈
脍	T	膾
脏	T	臟 髒
脐	T	臍
脑	T	腦
脓	T	膿
脔	T	臠
脚	T	腳
脛	S	胫
脫	S	脱
脱	T	脫
脶	T	腡
脸	T	臉
脹	S	胀
腊	T	臘
腎	S	肾
腖	S	胨
腡	S	脶
腦	S	脑
腫	S	肿
腭	T	齶
腳	S	脚
腸	S	肠
腻	T	膩
腼	T	靦
腽	T	膃
腾	T	騰
膃	S	腽
膑	T	臏
膚	S	肤
膠	S	胶
膩	S	腻
膽	S	胆
膾	S	脍
膿	S	脓
臉	S	脸
臍	S	脐
臏	S	膑
臘	S	腊
臚	S	胪
臜	T	臢
臟	S	脏
臠	S	脔
臢	S	臜
臨	S	临
致	T	緻
臺	S	台
舆	T	輿
與	S	与
興	S	兴
舉	S	举
舊	S	旧
舍	T	捨
舣	T	艤
舰	T	艦
舱	T	艙
舻	T	艫
艙	S	舱
艤	S	舣
艦	S	舰
艫	S	舻
艰	T	艱
艱	S	艰
艳	T	艷
艷	S	艳
艺	T	藝
节	T	節
芈	T	羋
芗	T	薌
芜	T	蕪
芦	T	蘆
芸	T	蕓
芻	S	刍
苁	T	蓯
苇	T	葦
苈	T	藶
苋	T	莧
苌	T	萇
苍	T	蒼
苎	T	苧
苏	T	蘇
苧	S	苎
苧	T	薴
苹	T	蘋
范	T	範
茎	T	莖
茏	T	蘢
茑	T	蔦
茔	T	塋
茕	T	煢
茧	T	繭
茲	S	兹
荆	T	荊
荊	S	荆
荐	T	薦
荙	T	薘
荚	T	莢
荛	T	蕘
荜	T	蓽
荞	T	蕎
荟	T	薈
荠	T	薺
荡	T	盪 蕩
荣	T	榮
荤	T	葷
荥	T	滎
荦	T	犖
荧	T	熒
荨	T	蕁
荩	T	藎
荪	T	蓀
荫	T	蔭
荬	T	蕒
荭	T	葒
荮	T	葤
药	T	葯 藥
莅	T	蒞
莊	S	庄
莖	S	茎
莢	S	荚
莧	S	苋
莱	T	萊
莲	T	蓮
莳	T	蒔
莴	T	萵
莶	T	薟
获	T	獲 穫
莸	T	蕕
莹	T	瑩
莺	T	鶯
莼	T	蒓 蓴
華	S	华
萇	S	苌
萊	S	莱
萝	T	蘿
萤	T	螢
营	T	營
萦	T	縈
萧	T	蕭
萨	T	薩
萬	S	万
萵	S	莴
葉	S	叶
葒	S	荭
著	S	着
葤	S	荮
葦	S	苇
葯	S	药
葱	T	蔥
葷	S	荤
蒇	T	蕆
蒉	T	蕢
蒋	T	蔣
蒌	T	蔞
蒓	S	莼
蒔	S	莳
蒞	S	莅
蒼	S	苍
蓀	S	荪
蓋	S	盖
蓝	T	藍
蓟	T	薊
蓠	T	蘺
蓣	T	蕷
蓥	T	鎣
蓦	T	驀
蓮	S	莲
蓯	S	苁
蓴	S	莼
蓽	S	荜
蔂	T	虆
蔔	S	卜
蔞	S	蒌
蔣	S	蒋
蔥	S	葱
蔦	S	茑
蔭	S	荫
蔷	T	薔
蔹	T	蘞
蔺	T	藺
蔼	T	藹
蕁	S	荨
蕆	S	蒇
蕎	S	荞
蕒	S	荬
蕓	S	芸
蕕	S	莸
蕘	S	荛
蕢	S	蒉
蕩	S	荡
蕪	S	芜
蕭	S	萧
蕰	T	薀
蕲	T	蘄
蕴	T	藴 蘊
蕷	S	蓣
薀	S	蕰
薈	S	荟
薊	S	蓟
薌	S	芗
薔	S	蔷
薘	S	荙
薟	S	莶
薦	S	荐
薩	S	萨
薮	T	藪
薳	S	䓕
薴	S	苧
薺	S	荠
藍	S	蓝
藎	S	荩
藓	T	蘚
藝	S	艺
藥	S	药
藪	S	薮
藴	S	蕴
藶	S	苈
藹	S	蔼
藺	S	蔺
蘄	S	蕲
蘆	S	芦
蘇	S	苏
蘊	S	蕴
蘋	S	苹
蘖	T	櫱
蘚	S	藓
蘞	S	蔹
蘢	S	茏
蘭	S	兰
蘺	S	蓠
蘿	S	萝
虆	S	蔂
虏	T	虜
虑	T	慮
處	S	处
虚	T	虛
虛	S	虚
虜	S	虏
號	S	号
虧	S	亏
虫	T	蟲
虬	T	虯
虮	T	蟣
虯	S	虬
虽	T	雖
虾	T	蝦
虿	T	蠆
蚀	T	蝕
蚁	T	蟻
蚂	T	螞
蚕	T	蠶
蚬	T	蜆
蛊	T	蠱
蛎	T	蠣
蛏	T	蟶
蛮	T	蠻
蛰	T	蟄
蛱	T	蛺
蛲	T	蟯
蛳	T	螄
蛴	T	蠐
蛺	S	蛱
蛻	S	蜕
蜆	S	蚬
蜕	T	蛻
蜗	T	蝸
蜡	S	蜡
蜡	T	蜡 蠟
蝇	T	蠅
蝈	T	蟈
蝉	T	蟬
蝕	S	蚀
蝟	S	猬
蝦	S	虾
蝸	S	蜗
蝼	T	螻
蝾	T	蠑
螀	T	螿
螄	S	蛳
螞	S	蚂
螢	S	萤
螨	T	蟎
螮	S	䗖
螻	S	蝼
螿	S	螀
蟄	S	蛰
蟈	S	蝈
蟎	S	螨
蟏	T	蠨
蟣	S	虮
蟬	S	蝉
蟯	S	蛲
蟲	S	虫
蟶	S	蛏
蟻	S	蚁
蠅	S	蝇
蠆	S	虿
蠐	S	蛴
蠑	S	蝾
蠟	S	蜡
蠣	S	蛎
蠨	S	蟏
蠱	S	蛊
蠶	S	蚕
蠻	S	蛮
衅	T	釁
衆	S	众
術	S	术
衔	T	銜
衕	S	同
衚	S	胡
衛	S	卫
衝	S	冲
补	T	補
表	T	錶
衬	T	襯
衮	T	袞
衹	S	只
袄	T	襖
袅	T	裊
袆	T	褘
袜	T	襪
袞	S	衮
袭	T	襲
袯	T	襏
装	T	裝
裆	T	襠
裈	T	褌
裊	S	袅
裏	S	里
補	S	补
裝	S	装
裡	S	里
裢	T	褳
裣	T	襝
裤	T	褲
裥	T	襇
製	S	制
複	S	复
褌	S	裈
褘	S	袆
褛	T	褸
褲	S	裤
褳	S	裢
褴	T	襤
褸	S	褛
褻	S	亵
襇	S	裥
襏	S	袯
襖	S	袄
襝	S	裣
襠	S	裆
襤	S	褴
襪	S	袜
襬	S	䙓
襯	S	衬
襲	S	袭
覆	S	复
見	S	见
覎	S	觃
規	S	规
覓	S	觅
視	S	视
覘	S	觇
覡	S	觋
覥	S	觍
覦	S	觎
親	S	亲
覬	S	觊
覯	S	觏
覲	S	觐
覷	S	觑
覺	S	觉
覽	S	览
覿	S	觌
觀	S	观
见	T	見
观	T	觀
觃	T	覎
规	T	規
觅	T	覓
视	T	視
觇	T	覘
览	T	覽
觉	T	覺
觊	T	覬
觋	T	覡
觌	T	覿
觍	T	覥
觎	T	覦
觏	T	覯
觐	T	覲
觑	T	覷
觞	T	觴
触	T	觸
觯	T	觶
觴	S	觞
觶	S	觯
觸	S	触
訁	S	讠
訂	S	订
訃	S	讣
計	S	计
訊	S	讯
訌	S	讧
討	S	讨
訐	S	讦
訒	S	讱
訓	S	训
訕	S	讪
訖	S	讫
託	S	讬
記	S	记
訚	T	誾
訛	S	讹
訝	S	讶
訟	S	讼
訢	S	䜣
訣	S	诀
訥	S	讷
訩	S	讻
訪	S	访
設	S	设
許	S	许
訴	S	诉
訶	S	诃
診	S	诊
註	S	注
詁	S	诂
詆	S	诋
詎	S	讵
詐	S	诈
詒	S	诒
詔	S	诏
評	S	评
詖	S	诐
詗	S	诇
詘	S	诎
詛	S	诅
詞	S	词
詠	S	咏
詡	S	诩
詢	S	询
詣	S	诣
試	S	试
詩	S	诗
詫	S	诧
詬	S	诟
詭	S	诡
詮	S	诠
詰	S	诘
話	S	话
該	S	该
詳	S	详
詵	S	诜
詼	S	诙
詿	S	诖
誄	S	诔
誅	S	诛
誆	S	诓
誇	S	夸
誉	T	譽
誊	T	謄
誌	S	志
認	S	认
誑	S	诳
誒	S	诶
誕	S	诞
誘	S	诱
誚	S	诮
語	S	语
誠	S	诚
誡	S	诫
誣	S	诬
誤	S	误
誥	S	诰
誦	S	诵
誨	S	诲
說	S	说
説	S	说
誰	S	谁
課	S	课
誶	S	谇
誹	S	诽
誼	S	谊
誾	S	訚
調	S	调
諂	S	谄
諄	S	谆
談	S	谈
諉	S	诿
請	S	请
諍	S	诤
諏	S	诹
諑	S	诼
諒	S	谅
論	S	论
諗	S	谂
諛	S	谀
諜	S	谍
諝	S	谞
諞	S	谝
諢	S	诨
諤	S	谔
諦	S	谛
諧	S	谐
諫	S	谏
諭	S	谕
諮	S	谘
諱	S	讳
諳	S	谙
諶	S	谌
諷	S	讽
諸	S	诸
諺	S	谚
諼	S	谖
諾	S	诺
謀	S	谋
謁	S	谒
謂	S	谓
謄	S	誊
謅	S	诌
謊	S	谎
謎	S	谜
謐	S	谧
謔	S	谑
謖	S	谡
謗	S	谤
謙	S	谦
謚	S	谥
講	S	讲
謝	S	谢
謠	S	谣
謡	S	谣
謨	S	谟
謫	S	谪
謬	S	谬
謭	S	谫
謳	S	讴
謹	S	谨
謾	S	谩
譅	S	䜧
證	S	证
譎	S	谲
譏	S	讥
譖	S	谮
識	S	识
譙	S	谯
譚	S	谭
譜	S	谱
譫	S	谵
譯	S	译
議	S	议
譴	S	谴
護	S	护
譸	S	诪
譽	S	誉
譾	S	谫
讀	S	读
變	S	变
讎	S	雠
讒	S	谗
讓	S	让
讕	S	谰
讖	S	谶
讜	S	谠
讞	S	谳
讠	T	訁
计	T	計
订	T	訂
讣	T	訃
认	T	認
讥	T	譏
讦	T	訐
讧	T	訌
讨	T	討
让	T	讓
讪	T	訕
讫	T	訖
讬	T	託
训	T	訓
议	T	議
讯	T	訊
记	T	記
讱	T	訒
讲	T	講
讳	T	諱
讴	T	謳
讵	T	詎
讶	T	訝
讷	T	訥
许	T	許
讹	T	訛
论	T	論
讻	T	訩
讼	T	訟
讽	T	諷
设	T	設
访	T	訪
诀	T	訣
证	T	證
诂	T	詁
诃	T	訶
评	T	評
诅	T	詛
识	T	識
诇	T	詗
诈	T	詐
诉	T	訴
诊	T	診
诋	T	詆
诌	T	謅
词	T	詞
诎	T	詘
诏	T	詔
诐	T	詖
译	T	譯
诒	T	詒
诓	T	誆
诔	T	誄
试	T	試
诖	T	詿
诗	T	詩
诘	T	詰
诙	T	詼
诚	T	誠
诛	T	誅
诜	T	詵
话	T	話
诞	T	誕
诟	T	詬
诠	T	詮
诡	T	詭
询	T	詢
诣	T	詣
诤	T	諍
该	T	該
详	T	詳
诧	T	詫
诨	T	諢
诩	T	詡
诪	T	譸
诫	T	誡
诬	T	誣
语	T	語
诮	T	誚
误	T	誤
诰	T	誥
诱	T	誘
诲	T	誨
诳	T	誑
说	T	說 説
诵	T	誦
诶	T	誒
请	T	請
诸	T	諸
诹	T	諏
诺	T	諾
读	T	讀
诼	T	諑
诽	T	誹
课	T	課
诿	T	諉
谀	T	諛
谁	T	誰
谂	T	諗
调	T	調
谄	T	諂
谅	T	諒
谆	T	諄
谇	T	誶
谈	T	談
谊	T	誼
谋	T	謀
谌	T	諶
谍	T	諜
谎	T	謊
谏	T	諫
谐	T	諧
谑	T	謔
谒	T	謁
谓	T	謂
谔	T	諤
谕	T	諭
谖	T	諼
谗	T	讒
谘	T	諮
谙	T	諳
谚	T	諺
谛	T	諦
谜	T	謎
谝	T	諞
谞	T	諝
谟	T	謨
谠	T	讜
谡	T	謖
谢	T	謝
谣	T	謠 謡
谤	T	謗
谥	T	謚
谦	T	謙
谧	T	謐
谨	T	謹
谩	T	謾
谪	T	謫
谫	T	謭 譾
谬	T	謬
谭	T	譚
谮	T	譖
谯	T	譙
谰	T	讕
谱	T	譜
谲	T	譎
谳	T	讞
谴	T	譴
谵	T	譫
谶	T	讖
谷	T	穀
豈	S	岂
豎	S	竖
豐	S	丰
豬	S	猪
豮	T	豶
豶	S	豮
貓	S	猫
貙	S	䝙
貝	S	贝
貞	S	贞
貟	S	贠
負	S	负
財	S	财
貢	S	贡
貧	S	贫
貨	S	货
販	S	贩
貪	S	贪
貫	S	贯
責	S	责
貯	S	贮
貰	S	贳
貲	S	赀
貳	S	贰
貴	S	贵
貶	S	贬
買	S	买
貸	S	贷
貺	S	贶
費	S	费
貼	S	贴
貽	S	贻
貿	S	贸
賀	S	贺
賁	S	贲
賂	S	赂
賃	S	赁
賄	S	贿
賅	S	赅
資	S	资
賈	S	贾
賊	S	贼
賑	S	赈
賒	S	赊
賓	S	宾
賕	S	赇
賙	S	赒
賚	S	赉
賜	S	赐
賞	S	赏
賠	S	赔
賡	S	赓
賢	S	贤
賣	S	卖
賤	S	贱
賦	S	赋
賧	S	赕
質	S	质
賫	S	赍
賬	S	账
賭	S	赌
賰	S	䞐
賴	S	赖
賵	S	赗
賺	S	赚
賻	S	赙
購	S	购
賽	S	赛
賾	S	赜
贄	S	贽
贅	S	赘
贇	S	赟
贈	S	赠
贊	S	赞
贋	S	赝
贍	S	赡
贏	S	赢
贐	S	赆
贓	S	赃
贔	S	赑
贖	S	赎
贗	S	赝
贛	S	赣
贜	S	赃
贝	T	貝
贞	T	貞
负	T	負
贠	T	貟
贡	T	貢
财	T	財
责	T	責
贤	T	賢
败	T	敗
账	T	賬
货	T	貨
质	T	質
贩	T	販
贪	T	貪
贫	T	貧
贬	T	貶
购	T	購
贮	T	貯
贯	T	貫
贰	T	貳
贱	T	賤
贲	T	賁
贳	T	貰
贴	T	貼
贵	T	貴
贶	T	貺
贷	T	貸
贸	T	貿
费	T	費
贺	T	賀
贻	T	貽
贼	T	賊
贽	T	贄
贾	T	賈
贿	T	賄
赀	T	貲
赁	T	賃
赂	T	賂
赃	T	贓 贜
资	T	資
赅	T	賅
赆	T	贐
赇	T	賕
赈	T	賑
赉	T	賚
赊	T	賒
赋	T	賦
赌	T	賭
赍	T	賫 齎
赎	T	贖
赏	T	賞
赐	T	賜
赑	T	贔
赒	T	賙
赓	T	賡
赔	T	賠
赕	T	賧
赖	T	賴
赗	T	賵
赘	T	贅
赙	T	賻
赚	T	賺
赛	T	賽
赜	T	賾
赝	T	贋 贗
赞	T	贊
赟	T	贇
赠	T	贈
赡	T	贍
赢	T	贏
赣	T	贛
赪	T	赬
赬	S	赪
赵	T	趙
赶	T	趕
趋	T	趨
趕	S	赶
趙	S	赵
趨	S	趋
趱	T	趲
趲	S	趱
趸	T	躉
跃	T	躍
跄	T	蹌
跞	T	躒
跡	S	迹
践	T	踐
跶	T	躂
跷	T	蹺
跸	T	蹕
跹	T	躚
跻	T	躋
踊	T	踴
踌	T	躊
踐	S	践
踪	T	蹤
踬	T	躓
踯	T	躑
踴	S	踊
蹌	S	跄
蹑	T	躡
蹒	T	蹣
蹕	S	跸
蹣	S	蹒
蹤	S	踪
蹰	T	躕
蹺	S	跷
蹿	T	躥
躂	S	跶
躉	S	趸
躊	S	踌
躋	S	跻
躍	S	跃
躏	T	躪
躑	S	踯
躒	S	跞
躓	S	踬
躕	S	蹰
躚	S	跹
躜	T	躦
躡	S	蹑
躥	S	蹿
躦	S	躜
躪	S	躏
躯	T	軀
軀	S	躯
車	S	车
軋	S	轧
軌	S	轨
軍	S	军
軑	S	轪
軒	S	轩
軔	S	轫
軛	S	轭
軟	S	软
軤	S	轷
軫	S	轸
軲	S	轱
軸	S	轴
軹	S	轵
軺	S	轺
軻	S	轲
軼	S	轶
軾	S	轼
較	S	较
輅	S	辂
輇	S	辁
輈	S	辀
載	S	载
輊	S	轾
輒	S	辄
輓	S	挽
輔	S	辅
輕	S	轻
輛	S	辆
輜	S	辎
輝	S	辉
輞	S	辋
輟	S	辍
輥	S	辊
輦	S	辇
輩	S	辈
輪	S	轮
輬	S	辌
輯	S	辑
輳	S	辏
輸	S	输
輻	S	辐
輾	S	辗
輿	S	舆
轀	S	辒
轂	S	毂
轄	S	辖
轅	S	辕
轆	S	辘
轉	S	转
轍	S	辙
轎	S	轿
轔	S	辚
轟	S	轰
轡	S	辔
轢	S	轹
轤	S	轳
车	T	車
轧	T	軋
轨	T	軌
轩	T	軒
轪	T	軑
轫	T	軔
转	T	轉
轭	T	軛
轮	T	輪
软	T	軟
轰	T	轟
轱	T	軲
轲	T	軻
轳	T	轤
轴	T	軸
轵	T	軹
轶	T	軼
轷	T	軤
轸	T	軫
轹	T	轢
轺	T	軺
轻	T	輕
轼	T	軾
载	T	載
轾	T	輊
轿	T	轎
辀	T	輈
辁	T	輇
辂	T	輅
较	T	較
辄	T	輒
辅	T	輔
辆	T	輛
辇	T	輦
辈	T	輩
辉	T	輝
辊	T	輥
辋	T	輞
辌	T	輬
辍	T	輟
辎	T	輜
辏	T	輳
辐	T	輻
辑	T	輯
辒	T	轀
输	T	輸
辔	T	轡
辕	T	轅
辖	T	轄
辗	T	輾
辘	T	轆
辙	T	轍
辚	T	轔
辞	T	辭
辦	S	办
辩	T	辯
辫	T	辮
辭	S	辞
辮	S	辫
辯	S	辩
農	S	农
边	T	邊
辽	T	遼
达	T	達
迁	T	遷
过	T	過
迈	T	邁
运	T	運
还	T	還
这	T	這
进	T	進
远	T	遠
违	T	違
连	T	連
迟	T	遲
迩	T	邇
迳	T	逕
迹	T	跡
适	T	適
选	T	選
逊	T	遜
递	T	遞
逕	S	迳
這	S	这
連	S	连
逦	T	邐
進	S	进
逻	T	邏
運	S	运
過	S	过
達	S	达
違	S	违
遗	T	遺
遙	S	遥
遜	S	逊
遞	S	递
遠	S	远
遥	T	遙
適	S	适
遲	S	迟
遷	S	迁
選	S	选
遺	S	遗
遼	S	辽
邁	S	迈
還	S	还
邇	S	迩
邊	S	边
邏	S	逻
邐	S	逦
邓	T	鄧
邝	T	鄺
邬	T	鄔
邮	T	郵
邹	T	鄒
邺	T	鄴
邻	T	鄰
郁	T	鬱
郏	T	郟
郐	T	鄶
郑	T	鄭
郓	T	鄆
郟	S	郏
郦	T	酈
郧	T	鄖
郵	S	邮
郸	T	鄲
鄆	S	郓
鄉	S	乡
鄒	S	邹
鄔	S	邬
鄖	S	郧
鄧	S	邓
鄭	S	郑
鄰	S	邻
鄲	S	郸
鄴	S	邺
鄶	S	郐
鄺	S	邝
酂	T	酇
酇	S	酂
酈	S	郦
酝	T	醖 醞
酦	T	醱
酱	T	醬
酽	T	釅
酾	T	釃
酿	T	釀
醖	S	酝
醜	S	丑
醞	S	酝
醫	S	医
醬	S	酱
醱	S	酦
釀	S	酿
釁	S	衅
釃	S	酾
釅	S	酽
采	T	埰 採
释	T	釋
釋	S	释
里	T	裏 裡
釐	S	厘
釒	S	钅
釓	S	钆
釔	S	钇
釕	S	钌
釗	S	钊
釘	S	钉
釙	S	钋
針	S	针
釣	S	钓
釤	S	钐
釧	S	钏
釩	S	钒
釵	S	钗
釷	S	钍
釹	S	钕
釺	S	钎
鈀	S	钯
鈁	S	钫
鈃	S	钘
鈄	S	钭
鈈	S	钚
鈉	S	钠
鈍	S	钝
鈎	S	钩
鈐	S	钤
鈑	S	钣
鈒	S	钑
鈔	S	钞
鈕	S	钮
鈞	S	钧
鈣	S	钙
鈥	S	钬
鈦	S	钛
鈧	S	钪
鈮	S	铌
鈰	S	铈
鈳	S	钶
鈴	S	铃
鈷	S	钴
鈸	S	钹
鈹	S	铍
鈺	S	钰
鈽	S	钸
鈾	S	铀
鈿	S	钿
鉀	S	钾
鉅	S	钜
鉈	S	铊
鉉	S	铉
鉋	S	铇
鉍	S	铋
鉑	S	铂
鉕	S	钷
鉗	S	钳
鉚	S	铆
鉛	S	铅
鉞	S	钺
鉢	S	钵
鉤	S	钩
鉦	S	钲
鉬	S	钼
鉭	S	钽
鉴	T	鑒
鉶	S	铏
鉸	S	铰
鉺	S	铒
鉻	S	铬
鉿	S	铪
銀	S	银
銃	S	铳
銅	S	铜
銍	S	铚
銑	S	铣
銓	S	铨
銖	S	铢
銘	S	铭
銚	S	铫
銛	S	铦
銜	S	衔
銠	S	铑
銣	S	铷
銥	S	铱
銦	S	铟
銨	S	铵
銩	S	铥
銪	S	铕
銫	S	铯
銬	S	铐
銮	T	鑾
銱	S	铞
銳	S	锐
銷	S	销
銹	S	锈
銻	S	锑
銼	S	锉
鋁	S	铝
鋃	S	锒
鋅	S	锌
鋇	S	钡
鋌	S	铤
鋏	S	铗
鋒	S	锋
鋙	S	铻
鋝	S	锊
鋟	S	锓
鋣	S	铘
鋤	S	锄
鋥	S	锃
鋦	S	锔
鋨	S	锇
鋩	S	铓
鋪	S	铺
鋭	S	锐
鋮	S	铖
鋯	S	锆
鋰	S	锂
鋱	S	铽
鋶	S	锍
鋸	S	锯
鋼	S	钢
錁	S	锞
錄	S	录
錆	S	锖
錇	S	锫
錈	S	锩
錏	S	铔
錐	S	锥
錒	S	锕
錕	S	锟
錘	S	锤
錙	S	锱
錚	S	铮
錛	S	锛
錟	S	锬
錠	S	锭
錡	S	锜
錢	S	钱
錦	S	锦
錨	S	锚
錩	S	锠
錫	S	锡
錮	S	锢
錯	S	错
録	S	录
錳	S	锰
錶	S	表
錸	S	铼
錾	T	鏨
鍀	S	锝
鍁	S	锨
鍃	S	锪
鍆	S	钔
鍇	S	锴
鍈	S	锳
鍋	S	锅
鍍	S	镀
鍔	S	锷
鍘	S	铡
鍚	S	钖
鍛	S	锻
鍠	S	锽
鍤	S	锸
鍥	S	锲
鍩	S	锘
鍬	S	锹
鍰	S	锾
鍵	S	键
鍶	S	锶
鍺	S	锗
鍾	S	钟 锺
鎂	S	镁
鎄	S	锿
鎇	S	镅
鎊	S	镑
鎔	S	镕
鎖	S	锁
鎘	S	镉
鎚	S	锤
鎛	S	镈
鎝	S	
鎡	S	镃
鎢	S	钨
鎣	S	蓥
鎦	S	镏
鎧	S	铠
鎩	S	铩
鎪	S	锼
鎬	S	镐
鎮	S	镇
鎰	S	镒
鎲	S	镋
鎳	S	镍
鎵	S	镓
鎸	S	镌
鎿	S	镎
鏃	S	镞
鏇	S	镟
鏈	S	链
鏌	S	镆
鏍	S	镙
鏐	S	镠
鏑	S	镝
鏗	S	铿
鏘	S	锵
鏜	S	镗
鏝	S	镘
鏞	S	镛
鏟	S	铲
鏡	S	镜
鏢	S	镖
鏤	S	镂
鏨	S	錾
鏰	S	镚
鏵	S	铧
鏷	S	镤
鏹	S	镪
鏽	S	锈
鐃	S	铙
鐋	S	铴
鐐	S	镣
鐒	S	铹
鐓	S	镦
鐔	S	镡
鐘	S	钟
鐙	S	镫
鐝	S	镢
鐠	S	镨
鐦	S	锎
鐧	S	锏
鐨	S	镄
鐫	S	镌
鐮	S	镰
鐲	S	镯
鐳	S	镭
鐵	S	铁
鐶	S	镮
鐸	S	铎
鐺	S	铛
鐿	S	镱
鑄	S	铸
鑊	S	镬
鑌	S	镔
鑒	S	鉴
鑔	S	镲
鑕	S	锧
鑞	S	镴
鑠	S	铄
鑣	S	镳
鑥	S	镥
鑭	S	镧
鑰	S	钥
鑱	S	镵
鑲	S	镶
鑷	S	镊
鑹	S	镩
鑼	S	锣
鑽	S	钻
鑾	S	銮
鑿	S	凿
钁	S	镢
钅	T	釒
钆	T	釓
钇	T	釔
针	T	針
钉	T	釘
钊	T	釗
钋	T	釙
钌	T	釕
钍	T	釷
钎	T	釺
钏	T	釧
钐	T	釤
钑	T	鈒
钒	T	釩
钓	T	釣
钔	T	鍆
钕	T	釹
钖	T	鍚
钗	T	釵
钘	T	鈃
钙	T	鈣
钚	T	鈈
钛	T	鈦
钜	T	鉅
钝	T	鈍
钞	T	鈔
钟	T	鍾 鐘
钠	T	鈉
钡	T	鋇
钢	T	鋼
钣	T	鈑
钤	T	鈐
钥	T	鑰
钦	T	欽
钧	T	鈞
钨	T	鎢
钩	T	鈎 鉤
钪	T	鈧
钫	T	鈁
钬	T	鈥
钭	T	鈄
钮	T	鈕
钯	T	鈀
钰	T	鈺
钱	T	錢
钲	T	鉦
钳	T	鉗
钴	T	鈷
钵	T	缽 鉢
钶	T	鈳
钷	T	鉕
钸	T	鈽
钹	T	鈸
钺	T	鉞
钻	T	鑽
钼	T	鉬
钽	T	鉭
钾	T	鉀
钿	T	鈿
铀	T	鈾
铁	T	鐵
铂	T	鉑
铃	T	鈴
铄	T	鑠
铅	T	鉛
铆	T	鉚
铇	T	鉋
铈	T	鈰
铉	T	鉉
铊	T	鉈
铋	T	鉍
铌	T	鈮
铍	T	鈹
铎	T	鐸
铏	T	鉶
铐	T	銬
铑	T	銠
铒	T	鉺
铓	T	鋩
铔	T	錏
铕	T	銪
铖	T	鋮
铗	T	鋏
铘	T	鋣
铙	T	鐃
铚	T	銍
铛	T	鐺
铜	T	銅
铝	T	鋁
铞	T	銱
铟	T	銦
铠	T	鎧
铡	T	鍘
铢	T	銖
铣	T	銑
铤	T	鋌
铥	T	銩
铦	T	銛
铧	T	鏵
铨	T	銓
铩	T	鎩
铪	T	鉿
铫	T	銚
铬	T	鉻
铭	T	銘
铮	T	錚
铯	T	銫
铰	T	鉸
铱	T	銥
铲	T	鏟
铳	T	銃
铴	T	鐋
铵	T	銨
银	T	銀
铷	T	銣
铸	T	鑄
铹	T	鐒
铺	T	鋪
铻	T	鋙
铼	T	錸
铽	T	鋱
链	T	鏈
铿	T	鏗
销	T	銷
锁	T	鎖
锂	T	鋰
锃	T	鋥
锄	T	鋤
锅	T	鍋
锆	T	鋯
锇	T	鋨
锈	T	銹 鏽
锉	T	銼
锊	T	鋝
锋	T	鋒
锌	T	鋅
锍	T	鋶
锎	T	鐦
锏	T	鐧
锐	T	銳 鋭
锑	T	銻
锒	T	鋃
锓	T	鋟
锔	T	鋦
锕	T	錒
锖	T	錆
锗	T	鍺
锘	T	鍩
错	T	錯
锚	T	錨
锛	T	錛
锜	T	錡
锝	T	鍀
锞	T	錁
锟	T	錕
锠	T	錩
锡	T	錫
锢	T	錮
锣	T	鑼
锤	T	錘 鎚
锥	T	錐
锦	T	錦
锧	T	鑕
锨	T	杴 鍁
锩	T	錈
锪	T	鍃
锫	T	錇
锬	T	錟
锭	T	錠
键	T	鍵
锯	T	鋸
锰	T	錳
锱	T	錙
锲	T	鍥
锳	T	鍈
锴	T	鍇
锵	T	鏘
锶	T	鍶
锷	T	鍔
锸	T	鍤
锹	T	鍬
锺	T	鍾
锻	T	鍛
锼	T	鎪
锽	T	鍠
锾	T	鍰
锿	T	鎄
镀	T	鍍
镁	T	鎂
镂	T	鏤
镃	T	鎡
镄	T	鐨
镅	T	鎇
镆	T	鏌
镇	T	鎮
镈	T	鎛
镉	T	鎘
镊	T	鑷
镋	T	鎲
镌	T	鎸 鐫
镍	T	鎳
镎	T	鎿
镏	T	鎦
镐	T	鎬
镑	T	鎊
镒	T	鎰
镓	T	鎵
镔	T	鑌
镕	T	鎔
镖	T	鏢
镗	T	鏜
镘	T	鏝
镙	T	鏍
镚	T	鏰
镛	T	鏞
镜	T	鏡
镝	T	鏑
镞	T	鏃
镟	T	鏇
镠	T	鏐
镡	T	鐔
镢	T	鐝 钁
镣	T	鐐
镤	T	鏷
镥	T	鑥
镦	T	鐓
镧	T	鑭
镨	T	鐠
镩	T	鑹
镪	T	鏹
镫	T	鐙
镬	T	鑊
镭	T	鐳
镮	T	鐶
镯	T	鐲
镰	T	鐮
镱	T	鐿
镲	T	鑔
镳	T	鑣
镴	T	鑞
镵	T	鑱
镶	T	鑲
長	S	长
长	T	長
門	S	门
閂	S	闩
閃	S	闪
閆	S	闫
閈	S	闬
閉	S	闭
開	S	开
閌	S	闶
閎	S	闳
閏	S	闰
閑	S	闲
間	S	间
閔	S	闵
閘	S	闸
閡	S	阂
閣	S	阁
閥	S	阀
閨	S	闺
閩	S	闽
閫	S	阃
閬	S	阆
閭	S	闾
閱	S	阅
閲	S	阅
閶	S	阊
閹	S	阉
閻	S	阎
閼	S	阏
閽	S	阍
閾	S	阈
閿	S	阌
闃	S	阒
闆	S	板
闈	S	闱
闊	S	阔
闋	S	阕
闌	S	阑
闍	S	阇
闐	S	阗
闒	S	阘
闓	S	闿
闔	S	阖
闕	S	阙
闖	S	闯
關	S	关
闞	S	阚
闠	S	阓
闡	S	阐
闤	S	阛
闥	S	闼
门	T	門
闩	T	閂
闪	T	閃
闫	T	閆
闬	T	閈
闭	T	閉
问	T	問
闯	T	闖
闰	T	閏
闱	T	闈
闲	T	閑
闳	T	閎
间	T	間
闵	T	閔
闶	T	閌
闷	T	悶
闸	T	閘
闹	T	鬧
闺	T	閨
闻	T	聞
闼	T	闥
闽	T	閩
闾	T	閭
闿	T	闓
阀	T	閥
阁	T	閣
阂	T	閡
阃	T	閫
阄	T	鬮
阅	T	閱 閲
阆	T	閬
阇	T	闍
阈	T	閾
阉	T	閹
阊	T	閶
阋	T	鬩
阌	T	閿
阍	T	閽
阎	T	閻
阏	T	閼
阐	T	闡
阑	T	闌
阒	T	闃
阓	T	闠
阔	T	闊
阕	T	闋
阖	T	闔
阗	T	闐
阘	T	闒
阙	T	闕
阚	T	闞
阛	T	闤
队	T	隊
阪	S	坂
阳	T	陽
阴	T	陰
阵	T	陣
阶	T	階
际	T	際
陆	T	陸
陇	T	隴
陈	T	陳
陉	T	陘
陕	T	陝
陘	S	陉
陝	S	陕
陣	S	阵
陧	T	隉
陨	T	隕
险	T	險
陰	S	阴
陳	S	陈
陸	S	陆
陽	S	阳
隉	S	陧
隊	S	队
階	S	阶
随	T	隨
隐	T	隱
隕	S	陨
際	S	际
隨	S	随
險	S	险
隱	S	隐
隴	S	陇
隶	T	隸
隸	S	隶
隻	S	只
隽	T	雋
难	T	難
雋	S	隽
雏	T	雛
雖	S	虽
雙	S	双
雛	S	雏
雜	S	杂
雞	S	鸡
雠	T	讎
離	S	离
難	S	难
雲	S	云
雳	T	靂
電	S	电
雾	T	霧
霁	T	霽
霡	T	霢
霢	S	霡
霧	S	雾
霭	T	靄
霽	S	霁
靂	S	雳
靄	S	霭
靈	S	灵
靓	T	靚
静	T	靜
靚	S	靓
靜	S	静
面	T	麵
靥	T	靨
靦	S	腼 䩄
靨	S	靥
鞀	S	鼗
鞏	S	巩
鞑	T	韃
鞒	T	鞽
鞝	S	绱
鞯	T	韉
鞽	S	鞒
韁	S	缰
韃	S	鞑
韉	S	鞯
韋	S	韦
韌	S	韧
韍	S	韨
韓	S	韩
韙	S	韪
韜	S	韬
韞	S	韫
韦	T	韋
韧	T	韌
韨	T	韍
韩	T	韓
韪	T	韙
韫	T	韞
韬	T	韜
韵	T	韻
韻	S	韵
響	S	响
頁	S	页
頂	S	顶
頃	S	顷
項	S	项
順	S	顺
頇	S	顸
須	S	须
頊	S	顼
頌	S	颂
頎	S	颀
頏	S	颃
預	S	预
頑	S	顽
頒	S	颁
頓	S	顿
頗	S	颇
領	S	领
頜	S	颌
頡	S	颉
頤	S	颐
頦	S	颏
頭	S	头
頮	S	颒
頰	S	颊
頲	S	颋
頴	S	颕
頷	S	颔
頸	S	颈
頹	S	颓
頻	S	频
頽	S	颓
顆	S	颗
題	S	题
額	S	额
顎	S	颚
顏	S	颜
顒	S	颙
顓	S	颛
顔	S	颜
願	S	愿
顙	S	颡
顛	S	颠
類	S	类
顢	S	颟
顥	S	颢
顧	S	顾
顫	S	颤
顬	S	颥
顯	S	显
顰	S	颦
顱	S	颅
顳	S	颞
顴	S	颧
页	T	頁
顶	T	頂
顷	T	頃
顸	T	頇
项	T	項
顺	T	順
须	T	須 鬚
顼	T	頊
顽	T	頑
顾	T	顧
顿	T	頓
颀	T	頎
颁	T	頒
颂	T	頌
颃	T	頏
预	T	預
颅	T	顱
领	T	領
颇	T	頗
颈	T	頸
颉	T	頡
颊	T	頰
颋	T	頲
颌	T	頜
颍	T	潁
颎	T	熲
颏	T	頦
颐	T	頤
频	T	頻
颒	T	頮
颓	T	頹 頽
颔	T	頷
颕	T	頴
颖	T	穎
颗	T	顆
题	T	題
颙	T	顒
颚	T	顎
颛	T	顓
颜	T	顏 顔
额	T	額
颞	T	顳
颟	T	顢
颠	T	顛
颡	T	顙
颢	T	顥
颤	T	顫
颥	T	顬
颦	T	顰
颧	T	顴
風	S	风
颭	S	飐
颮	S	飑
颯	S	飒
颱	S	台
颳	S	刮
颶	S	飓
颸	S	飔
颺	S	飏
颻	S	飖
颼	S	飕
飀	S	飗
飄	S	飘
飆	S	飙
飈	S	飚
风	T	風
飏	T	颺
飐	T	颭
飑	T	颮
飒	T	颯
飓	T	颶
飔	T	颸
飕	T	颼
飖	T	颻
飗	T	飀
飘	T	飄
飙	T	飆
飚	T	飈
飛	S	飞
飞	T	飛
飠	S	饣
飢	S	饥
飣	S	饤
飥	S	饦
飨	T	饗
飩	S	饨
飪	S	饪
飫	S	饫
飭	S	饬
飯	S	饭
飲	S	饮
飴	S	饴
飼	S	饲
飽	S	饱
飾	S	饰
飿	S	饳
餃	S	饺
餄	S	饸
餅	S	饼
餉	S	饷
養	S	养
餌	S	饵
餍	T	饜
餎	S	饹
餏	S	饻
餑	S	饽
餒	S	馁
餓	S	饿
餕	S	馂
餖	S	饾
餘	S	余 馀
餚	S	肴
餛	S	馄
餜	S	馃
餞	S	饯
餡	S	馅
館	S	馆
餱	S	糇
餳	S	饧
餶	S	馉
餷	S	馇
餺	S	馎
餼	S	饩
餾	S	馏
餿	S	馊
饁	S	馌
饃	S	馍
饅	S	馒
饈	S	馐
饉	S	馑
饊	S	馓
饋	S	馈
饌	S	馔
饑	S	饥
饒	S	饶
饗	S	飨
饜	S	餍
饞	S	馋
饢	S	馕
饣	T	飠
饤	T	飣
饥	T	飢 饑
饦	T	飥
饧	T	餳
饨	T	飩
饩	T	餼
饪	T	飪
饫	T	飫
饬	T	飭
饭	T	飯
饮	T	飲
饯	T	餞
饰	T	飾
饱	T	飽
饲	T	飼
饳	T	飿
饴	T	飴
饵	T	餌
饶	T	饒
饷	T	餉
饸	T	餄
饹	T	餎
饺	T	餃
饻	T	餏
饼	T	餅
饽	T	餑
饾	T	餖
饿	T	餓
馀	T	余 餘
馁	T	餒
馂	T	餕
馃	T	餜
馄	T	餛
馅	T	餡
馆	T	館
馇	T	餷
馈	T	饋
馉	T	餶
馊	T	餿
馋	T	饞
馌	T	饁
馍	T	饃
馎	T	餺
馏	T	餾
馐	T	饈
馑	T	饉
馒	T	饅
馓	T	饊
馔	T	饌
馕	T	饢
馬	S	马
馭	S	驭
馮	S	冯
馱	S	驮
馳	S	驰
馴	S	驯
馹	S	驲
駁	S	驳
駐	S	驻
駑	S	驽
駒	S	驹
駔	S	驵
駕	S	驾
駘	S	骀
駙	S	驸
駛	S	驶
駝	S	驼
駟	S	驷
駡	S	骂
駢	S	骈
駭	S	骇
駰	S	骃
駱	S	骆
駸	S	骎
駿	S	骏
騁	S	骋
騂	S	骍
騅	S	骓
騌	S	骔
騍	S	骒
騎	S	骑
騏	S	骐
騖	S	骛
騙	S	骗
騤	S	骙
騧	S	䯄
騫	S	骞
騭	S	骘
騮	S	骝
騰	S	腾
騶	S	驺
騷	S	骚
騸	S	骟
騾	S	骡
驀	S	蓦
驁	S	骜
驂	S	骖
驃	S	骠
驄	S	骢
驅	S	驱
驊	S	骅
驌	S	骕
驍	S	骁
驏	S	骣
驕	S	骄
驗	S	验
驚	S	惊
驛	S	驿
驟	S	骤
驢	S	驴
驤	S	骧
驥	S	骥
驦	S	骦
驪	S	骊
驫	S	骉
马	T	馬
驭	T	馭
驮	T	馱
驯	T	馴
驰	T	馳
驱	T	驅
驲	T	馹
驳	T	駁
驴	T	驢
驵	T	駔
驶	T	駛
驷	T	駟
驸	T	駙
驹	T	駒
驺	T	騶
驻	T	駐
驼	T	駝
驽	T	駑
驾	T	駕
驿	T	驛
骀	T	駘
骁	T	驍
骂	T	罵 駡
骃	T	駰
骄	T	驕
骅	T	驊
骆	T	駱
骇	T	駭
骈	T	駢
骉	T	驫
骊	T	驪
骋	T	騁
验	T	驗
骍	T	騂
骎	T	駸
骏	T	駿
骐	T	騏
骑	T	騎
骒	T	騍
骓	T	騅
骔	T	騌
骕	T	驌
骖	T	驂
骗	T	騙
骘	T	騭
骙	T	騤
骚	T	騷
骛	T	騖
骜	T	驁
骝	T	騮
骞	T	騫
骟	T	騸
骠	T	驃
骡	T	騾
骢	T	驄
骣	T	驏
骤	T	驟
骥	T	驥
骦	T	驦
骧	T	驤
骯	S	肮
髅	T	髏
髋	T	髖
髌	T	髕
髏	S	髅
髒	S	脏
體	S	体
髕	S	髌
髖	S	髋
髮	S	发
鬆	S	松
鬍	S	胡
鬓	T	鬢
鬚	S	须
鬢	S	鬓
鬥	S	斗
鬧	S	闹
鬩	S	阋
鬮	S	阄
鬱	S	郁
魇	T	魘
魉	T	魎
魎	S	魉
魘	S	魇
魚	S	鱼
魛	S	鱽
魢	S	鱾
魨	S	鲀
魯	S	鲁
魴	S	鲂
魷	S	鱿
魺	S	鲄
鮁	S	鲅
鮃	S	鲆
鮊	S	鲌
鮋	S	鲉
鮍	S	鲏
鮎	S	鲇
鮐	S	鲐
鮑	S	鲍
鮒	S	鲋
鮓	S	鲊
鮚	S	鲒
鮜	S	鲘
鮝	S	鲞
鮞	S	鲕
鮦	S	鲖
鮪	S	鲔
鮫	S	鲛
鮭	S	鲑
鮮	S	鲜
鮳	S	鲓
鮶	S	鲪
鮺	S	鲝
鯀	S	鲧
鯁	S	鲠
鯇	S	鲩
鯉	S	鲤
鯊	S	鲨
鯒	S	鲬
鯔	S	鲻
鯕	S	鲯
鯖	S	鲭
鯗	S	鲞
鯛	S	鲷
鯝	S	鲴
鯡	S	鲱
鯢	S	鲵
鯤	S	鲲
鯧	S	鲳
鯨	S	鲸
鯪	S	鲮
鯫	S	鲰
鯰	S	鲇 鲶
鯴	S	鲺
鯷	S	鳀
鯽	S	鲫
鯿	S	鳊
鰁	S	鳈
鰂	S	鲗
鰃	S	鳂
鰈	S	鲽
鰉	S	鳇
鰍	S	鳅
鰏	S	鲾
鰐	S	鳄
鰒	S	鳆
鰓	S	鳃
鰜	S	鳒
鰟	S	鳑
鰠	S	鳋
鰣	S	鲥
鰥	S	鳏
鰨	S	鳎
鰩	S	鳐
鰭	S	鳍
鰮	S	鳁
鰱	S	鲢
鰲	S	鳌
鰳	S	鳓
鰵	S	鳘
鰷	S	鲦
鰹	S	鲣
鰺	S	鲹
鰻	S	鳗
鰼	S	鳛
鰾	S	鳔
鱂	S	鳉
鱅	S	鳙
鱈	S	鳕
鱉	S	鳖
鱒	S	鳟
鱔	S	鳝
鱖	S	鳜
鱗	S	鳞
鱘	S	鲟
鱝	S	鲼
鱟	S	鲎
鱠	S	鲙
鱣	S	鳣
鱤	S	鳡
鱧	S	鳢
鱨	S	鲿
鱭	S	鲚
鱯	S	鳠
鱷	S	鳄
鱸	S	鲈
鱺	S	鲡
鱼	T	魚
鱽	T	魛
鱾	T	魢
鱿	T	魷
鲀	T	魨
鲁	T	魯
鲂	T	魴
鲃	T	䰾
鲄	T	魺
鲅	T	鮁
鲆	T	鮃
鲇	T	鮎 鯰
鲈	T	鱸
鲉	T	鮋
鲊	T	鮓
鲋	T	鮒
鲌	T	鮊
鲍	T	鮑
鲎	T	鱟
鲏	T	鮍
鲐	T	鮐
鲑	T	鮭
鲒	T	鮚
鲓	T	鮳
鲔	T	鮪
鲕	T	鮞
鲖	T	鮦
鲗	T	鰂
鲘	T	鮜
鲙	T	鱠
鲚	T	鱭
鲛	T	鮫
鲜	T	鮮
鲝	T	鮺
鲞	T	鮝 鯗
鲟	T	鱘
鲠	T	鯁
鲡	T	鱺
鲢	T	鰱
鲣	T	鰹
鲤	T	鯉
鲥	T	鰣
鲦	T	鰷
鲧	T	鯀
鲨	T	鯊
鲩	T	鯇
鲪	T	鮶
鲫	T	鯽
鲬	T	鯒
鲭	T	鯖
鲮	T	鯪
鲯	T	鯕
鲰	T	鯫
鲱	T	鯡
鲲	T	鯤
鲳	T	鯧
鲴	T	鯝
鲵	T	鯢
鲶	T	鯰
鲷	T	鯛
鲸	T	鯨
鲹	T	鰺
鲺	T	鯴
鲻	T	鯔
鲼	T	鱝
鲽	T	鰈
鲾	T	鰏
鲿	T	鱨
鳀	T	鯷
鳁	T	鰮
鳂	T	鰃
鳃	T	鰓
鳄	T	鰐 鱷
鳅	T	鰍
鳆	T	鰒
鳇	T	鰉
鳈	T	鰁
鳉	T	鱂
鳊	T	鯿
鳋	T	鰠
鳌	T	鰲
鳍	T	鰭
鳎	T	鰨
鳏	T	鰥
鳐	T	鰩
鳑	T	鰟
鳒	T	鰜
鳓	T	鰳
鳔	T	鰾
鳕	T	鱈
鳖	T	鱉
鳗	T	鰻
鳘	T	鰵
鳙	T	鱅
鳚	T	䲁
鳛	T	鰼
鳜	T	鱖
鳝	T	鱔
鳞	T	鱗
鳟	T	鱒
鳠	T	鱯
鳡	T	鱤
鳢	T	鱧
鳣	T	鱣
鳥	S	鸟
鳧	S	凫
鳩	S	鸠
鳬	S	凫
鳲	S	鸤
鳳	S	凤
鳴	S	鸣
鳶	S	鸢
鳾	S	䴓
鴆	S	鸩
鴇	S	鸨
鴉	S	鸦
鴒	S	鸰
鴕	S	鸵
鴛	S	鸳
鴝	S	鸲
鴞	S	鸮
鴟	S	鸱
鴣	S	鸪
鴦	S	鸯
鴨	S	鸭
鴯	S	鸸
鴰	S	鸹
鴴	S	鸻
鴷	S	䴕
鴻	S	鸿
鴿	S	鸽
鵁	S	䴔
鵂	S	鸺
鵃	S	鸼
鵐	S	鹀
鵑	S	鹃
鵒	S	鹆
鵓	S	鹁
鵜	S	鹈
鵝	S	鹅
鵠	S	鹄
鵡	S	鹉
鵪	S	鹌
鵬	S	鹏
鵮	S	鹐
鵯	S	鹎
鵲	S	鹊
鵷	S	鹓
鵾	S	鹍
鶄	S	䴖
鶇	S	鸫
鶉	S	鹑
鶊	S	鹒
鶓	S	鹋
鶖	S	鹙
鶘	S	鹕
鶚	S	鹗
鶡	S	鹖
鶥	S	鹛
鶩	S	鹜
鶪	S	䴗
鶬	S	鸧
鶯	S	莺
鶲	S	鹟
鶴	S	鹤
鶹	S	鹠
鶺	S	鹡
鶻	S	鹘
鶼	S	鹣
鶿	S	鹚
鷀	S	鹚
鷁	S	鹢
鷂	S	鹞
鷄	S	鸡
鷈	S	䴘
鷊	S	鹝
鷓	S	鹧
鷖	S	鹥
鷗	S	鸥
鷙	S	鸷
鷚	S	鹨
鷥	S	鸶
鷦	S	鹪
鷫	S	鹔
鷯	S	鹩
鷲	S	鹫
鷳	S	鹇
鷸	S	鹬
鷹	S	鹰
鷺	S	鹭
鷽	S	鸴
鷿	S	䴙
鸂	S	㶉
鸇	S	鹯
鸌	S	鹱
鸏	S	鹲
鸕	S	鸬
鸘	S	鹴
鸚	S	鹦
鸛	S	鹳
鸝	S	鹂
鸞	S	鸾
鸟	T	鳥
鸠	T	鳩
鸡	T	雞 鷄
鸢	T	鳶
鸣	T	鳴
鸤	T	鳲
鸥	T	鷗
鸦	T	鴉
鸧	T	鶬
鸨	T	鴇
鸩	T	鴆
鸪	T	鴣
鸫	T	鶇
鸬	T	鸕
鸭	T	鴨
鸮	T	鴞
鸯	T	鴦
鸰	T	鴒
鸱	T	鴟
鸲	T	鴝
鸳	T	鴛
鸴	T	鷽
鸵	T	鴕
鸶	T	鷥
鸷	T	鷙
鸸	T	鴯
鸹	T	鴰
鸺	T	鵂
鸻	T	鴴
鸼	T	鵃
鸽	T	鴿
鸾	T	鸞
鸿	T	鴻
鹀	T	鵐
鹁	T	鵓
鹂	T	鸝
鹃	T	鵑
鹄	T	鵠
鹅	T	鵝
鹆	T	鵒
鹇	T	鷳
鹈	T	鵜
鹉	T	鵡
鹊	T	鵲
鹋	T	鶓
鹌	T	鵪
鹍	T	鵾
鹎	T	鵯
鹏	T	鵬
鹐	T	鵮
鹑	T	鶉
鹒	T	鶊
鹓	T	鵷
鹔	T	鷫
鹕	T	鶘
鹖	T	鶡
鹗	T	鶚
鹘	T	鶻
鹙	T	鶖
鹚	T	鶿 鷀
鹛	T	鶥
鹜	T	鶩
鹝	T	鷊
鹞	T	鷂
鹟	T	鶲
鹠	T	鶹
鹡	T	鶺
鹢	T	鷁
鹣	T	鶼
鹤	T	鶴
鹥	T	鷖
鹦	T	鸚
鹧	T	鷓
鹨	T	鷚
鹩	T	鷯
鹪	T	鷦
鹫	T	鷲
鹬	T	鷸
鹭	T	鷺
鹯	T	鸇
鹰	T	鷹
鹱	T	鸌
鹲	T	鸏
鹳	T	鸛
鹴	T	鸘
鹵	S	卤
鹹	S	咸
鹺	S	鹾
鹼	S	硷 碱
鹽	S	盐
鹾	T	鹺
麗	S	丽
麥	S	麦
麦	T	麥
麩	S	麸
麵	S	面
麸	T	麩
麼	S	么
麽	S	么
黃	S	黄
黄	T	黃
黉	T	黌
黌	S	黉
點	S	点
黡	T	黶
黨	S	党
黩	T	黷
黪	T	黲
黲	S	黪
黶	S	黡
黷	S	黩
黽	S	黾
黾	T	黽
黿	S	鼋
鼉	S	鼍
鼋	T	黿
鼍	T	鼉
鼗	T	鞀
鼴	S	鼹
鼹	T	鼴
齊	S	齐
齋	S	斋
齎	S	赍
齏	S	齑
齐	T	齊
齑	T	齏
齒	S	齿
齔	S	龀
齕	S	龁
齗	S	龂
齙	S	龅
齜	S	龇
齟	S	龃
齠	S	龆
齡	S	龄
齦	S	龈
齪	S	龊
齬	S	龉
齲	S	龋
齶	S	腭
齷	S	龌
齿	T	齒
龀	T	齔
龁	T	齕
龂	T	齗
龃	T	齟
龄	T	齡
龅	T	齙
龆	T	齠
龇	T	齜
龈	T	齦
龉	T	齬
龊	T	齪
龋	T	齲
龌	T	齷
龍	S	龙
龎	S	厐
龐	S	庞
龔	S	龚
龕	S	龛
龙	T	龍
龚	T	龔
龛	T	龕
龜	S	龟
龟	T	龜
	T	壈
	S	㛟
	S	㛿
	S	㛠
	S	㻘
	S	㻏
	S	䙊
	S	䘛
	S	䜥
	S	䞌
	S	䢂
	S	䦀
	S	䦁
	S	䥿
	T	鎝
	S	䯃
	S	䲞
